TICKER,Date,Open,High,Low,Close,Adj Close,Volume,H-L,C-O,7 DAYS MA,14 DAYS MA,21 DAYS MA,7 DAYS STD DEV,Next Day Close
EXCL.JK,2018-10-17,2820,2880,2800,2830,2717.772705,8749500,80,10,2815.714286,2811.428571,2832.857143,67.78818551,2830
EXCL.JK,2018-10-18,2830,2840,2760,2830,2717.772705,4661200,80,0,2801.428571,2812.142857,2826.666667,47.05619741,2780
EXCL.JK,2018-10-19,2830,2830,2750,2780,2669.755371,9249500,80,-50,2794.285714,2817.142857,2819.047619,35.52329886,2870
EXCL.JK,2018-10-22,2800,2900,2780,2870,2756.186523,10679900,120,70,2787.142857,2815.714286,2812.380952,31.99702367,2820
EXCL.JK,2018-10-23,2870,2870,2780,2820,2708.169189,4845500,90,-50,2804.285714,2824.285714,2813.333333,39.94043184,2760
EXCL.JK,2018-10-24,2790,2810,2740,2760,2650.548828,3900500,70,-30,2811.428571,2821.428571,2813.809524,37.16116765,2740
EXCL.JK,2018-10-25,2680,2780,2680,2740,2631.341553,3488300,100,60,2811.428571,2819.285714,2812.380952,37.16116765,2760
EXCL.JK,2018-10-26,2750,2780,2720,2760,2650.548828,4862700,60,10,2804.285714,2810,2809.047619,45.77377082,2680
EXCL.JK,2018-10-29,2760,2800,2670,2680,2573.721191,7137900,130,-80,2794.285714,2797.857143,2806.190476,46.85336802,2630
EXCL.JK,2018-10-30,2650,2740,2600,2630,2525.704102,6401200,140,-20,2772.857143,2783.571429,2802.380952,60.19808572,2620
EXCL.JK,2018-10-31,2640,2660,2580,2620,2516.100586,4664500,80,-20,2751.428571,2769.285714,2794.285714,80.5043625,2220
EXCL.JK,2018-11-01,2660,2670,2190,2220,2131.963135,52029600,480,-440,2715.714286,2760,2788.095238,74.35436388,2090
EXCL.JK,2018-11-02,2250,2310,2000,2090,2007.118408,88668000,310,-160,2630,2720.714286,2757.619048,190,2100
EXCL.JK,2018-11-05,2070,2140,2040,2100,2016.72168,28898300,100,30,2534.285714,2672.857143,2724.285714,266.8243581,2230
EXCL.JK,2018-11-06,2130,2240,2110,2230,2141.566406,38982100,130,100,2442.857143,2623.571429,2687.619048,292.9570097,2160
EXCL.JK,2018-11-07,2250,2270,2130,2160,2074.342529,25946000,140,-90,2367.142857,2580.714286,2654.285714,264.4311054,2270
EXCL.JK,2018-11-08,2200,2280,2140,2270,2179.980225,32014800,140,70,2292.857143,2532.857143,2620,233.0746866,2270
EXCL.JK,2018-11-09,2260,2300,2200,2270,2179.980225,14170300,100,10,2241.428571,2496.428571,2593.333333,179.9470822,2190
EXCL.JK,2018-11-12,2270,2280,2160,2190,2103.152832,13115400,120,-80,2191.428571,2453.571429,2570.47619,75.5928946,2120
EXCL.JK,2018-11-13,2150,2150,2090,2120,2035.928833,20623800,60,-30,2187.142857,2408.571429,2542.857143,74.54624643,2140
EXCL.JK,2018-11-14,2120,2160,2100,2140,2055.135498,15557900,60,20,2191.428571,2362.857143,2512.380952,68.66065623,2160
EXCL.JK,2018-11-15,2140,2200,2140,2160,2074.342529,10707200,60,20,2197.142857,2320,2481.428571,61.02302454,2200
EXCL.JK,2018-11-16,2160,2240,2130,2200,2112.756104,16645400,110,40,2187.142857,2277.142857,2449.52381,60.47431568,2190
EXCL.JK,2018-11-19,2210,2240,2140,2190,2103.152832,9953700,100,-20,2192.857143,2242.857143,2419.52381,59.36168397,2190
EXCL.JK,2018-11-20,2190,2190,2190,2190,2103.152832,0,0,0,2181.428571,2211.428571,2391.428571,48.79500365,2180
EXCL.JK,2018-11-21,2170,2210,2150,2180,2093.549316,4971200,60,10,2170,2180.714286,2359.047619,30.55050463,2210
EXCL.JK,2018-11-22,2210,2280,2180,2210,2122.359619,10282500,100,0,2168.571429,2177.857143,2328.571429,29.68084199,2220
EXCL.JK,2018-11-23,2210,2250,2210,2220,2131.963135,4753800,40,10,2181.428571,2186.428571,2302.380952,24.10295378,2210
EXCL.JK,2018-11-26,2240,2250,2180,2210,2122.359619,5444200,70,-30,2192.857143,2195,2277.619048,19.7604704,2200
EXCL.JK,2018-11-27,2210,2220,2180,2200,2112.756104,4738600,40,-10,2200,2193.571429,2251.428571,14.14213562,2030
EXCL.JK,2018-11-28,2180,2190,2010,2030,1949.497681,18635700,180,-150,2200,2196.428571,2228.571429,14.14213562,2050
EXCL.JK,2018-11-29,2040,2100,2030,2050,1968.704468,12457900,70,10,2177.142857,2179.285714,2200,66.2606685,2040
EXCL.JK,2018-11-30,2040,2060,1950,2040,1959.101196,17929200,110,0,2157.142857,2163.571429,2172.857143,81.18174789,2020
EXCL.JK,2018-12-03,2000,2050,1985,2020,1939.894287,10873300,65,20,2137.142857,2152.857143,2164.285714,91.23491395,1980
EXCL.JK,2018-12-04,2010,2010,1975,1980,1901.480591,11990300,35,-30,2110,2145.714286,2160.952381,94.16297928,1890
EXCL.JK,2018-12-05,1965,1965,1875,1890,1815.049683,24077800,90,-75,2075.714286,2134.285714,2155.238095,91.07819769,1950
EXCL.JK,2018-12-06,1890,1985,1880,1950,1872.670288,22524900,105,60,2030,2115,2139.047619,92.73618495,1960
EXCL.JK,2018-12-07,1960,2020,1955,1960,1882.273682,15009300,65,0,1994.285714,2097.142857,2129.047619,57.98193479,1915
EXCL.JK,2018-12-10,1960,1970,1900,1915,1839.058105,6676500,70,-45,1984.285714,2080.714286,2114.285714,56.82051943,1880
EXCL.JK,2018-12-11,1925,1925,1875,1880,1805.446167,7964300,50,-45,1965,2061.071429,2097.380952,53.61902647,1915
EXCL.JK,2018-12-12,1885,1935,1880,1915,1839.058105,11163500,55,30,1942.142857,2039.642857,2082.619048,50.320402,1945
EXCL.JK,2018-12-13,1940,1990,1915,1945,1867.868652,20301500,75,5,1927.142857,2018.571429,2072.857143,37.17718194,1920
EXCL.JK,2018-12-14,1945,1960,1920,1920,1843.859863,8055500,40,-25,1922.142857,1998.928571,2063.571429,30.66718426,1910
EXCL.JK,2018-12-17,1930,1935,1890,1910,1834.256592,7817200,45,-20,1926.428571,1978.214286,2052.142857,27.34262328,1935
EXCL.JK,2018-12-18,1920,1935,1890,1935,1858.265015,5999700,45,15,1920.714286,1957.5,2038.333333,25.72750983,2040
EXCL.JK,2018-12-19,1950,2040,1940,2040,1959.101196,27021900,100,90,1917.142857,1950.714286,2026.190476,20.58663459,2010
EXCL.JK,2018-12-20,2020,2100,2000,2010,1930.291016,31897000,100,-10,1935,1950,2019.047619,50.66228051,2050
EXCL.JK,2018-12-21,2010,2060,2000,2050,1968.704468,19388400,60,40,1953.571429,1947.857143,2010.952381,50.96684263,2050
EXCL.JK,2018-12-24,2050,2050,2050,2050,1968.704468,0,0,0,1972.857143,1950,2003.333333,58.86829529,2050
EXCL.JK,2018-12-25,2050,2050,2050,2050,1968.704468,0,0,0,1987.857143,1955,1995.238095,63.7610868,1940
EXCL.JK,2018-12-26,2050,2050,1930,1940,1863.066772,8224700,120,-110,2006.428571,1966.428571,1987.619048,59.49189621,2000
EXCL.JK,2018-12-27,1970,2040,1970,2000,1920.687378,15916700,70,30,2010.714286,1965.714286,1975.238095,51.99587896,1980
EXCL.JK,2018-12-28,2020,2020,1955,1980,1901.480591,22007600,65,-40,2020,1968.571429,1973.809524,40.82482905,1980
EXCL.JK,2018-12-31,1980,1980,1980,1980,1901.480591,0,0,0,2011.428571,1973.214286,1970.47619,42.20133151,1980
EXCL.JK,2019-01-01,1980,1980,1980,1980,1901.480591,0,0,0,2007.142857,1980.357143,1967.619048,43.8612531,1980
EXCL.JK,2019-01-02,2020,2020,1955,1980,1901.480591,5313100,65,-40,1997.142857,1985,1965.714286,40.29652,2020
EXCL.JK,2019-01-03,1980,2030,1970,2020,1939.894287,11314600,60,40,1987.142857,1987.5,1965.714286,33.02235895,2040
EXCL.JK,2019-01-04,2010,2080,1990,2040,1959.101196,18759700,90,30,1982.857143,1994.642857,1971.904762,24.29971585,2140
EXCL.JK,2019-01-07,2020,2160,2020,2140,2055.135498,51722500,140,120,1997.142857,2003.928571,1976.190476,24.29971585,2190
EXCL.JK,2019-01-08,2140,2200,2110,2190,2103.152832,32563100,90,50,2017.142857,2018.571429,1984.761905,59.36168397,2250
EXCL.JK,2019-01-09,2210,2270,2200,2250,2160.773438,28621800,70,40,2047.142857,2029.285714,1997.857143,84.99299691,2250
EXCL.JK,2019-01-10,2250,2270,2210,2250,2160.773438,13872500,60,0,2085.714286,2046.428571,2015.47619,107.6811873,2200
EXCL.JK,2019-01-11,2250,2260,2200,2200,2112.756104,11299600,60,-50,2124.285714,2060.714286,2031.428571,111.782101,2110
EXCL.JK,2019-01-14,2200,2200,2110,2110,2026.325195,13180700,90,-90,2155.714286,2071.428571,2043.571429,93.96047801,2190
EXCL.JK,2019-01-15,2120,2210,2120,2190,2103.152832,20372700,90,70,2168.571429,2075.714286,2052.619048,76.90439334,2310
EXCL.JK,2019-01-16,2190,2330,2190,2310,2218.394043,40171200,140,120,2190,2093.571429,2065.952381,51.96152423,2300
EXCL.JK,2019-01-17,2330,2370,2300,2300,2208.790283,21537800,70,-30,2214.285714,2115.714286,2083.809524,63.20789583,2290
EXCL.JK,2019-01-18,2300,2350,2280,2290,2199.187256,11992000,70,-10,2230,2138.571429,2096.190476,69.52217872,2250
EXCL.JK,2019-01-21,2310,2340,2230,2250,2160.773438,11608400,110,-60,2235.714286,2160.714286,2109.52381,72.99706452,2270
EXCL.JK,2019-01-22,2220,2330,2170,2270,2179.980225,22784000,160,50,2235.714286,2180,2119.047619,72.99706452,2320
EXCL.JK,2019-01-23,2270,2370,2270,2320,2227.997559,27481400,100,50,2245.714286,2200.714286,2129.52381,72.07800008,2330
EXCL.JK,2019-01-24,2350,2360,2310,2330,2237.601074,15091400,50,-20,2275.714286,2222.142857,2142.380952,44.66808811,2190
EXCL.JK,2019-01-25,2360,2370,2170,2190,2103.152832,37595300,200,-170,2295.714286,2242.857143,2160.952381,28.19996623,2130
EXCL.JK,2019-01-28,2220,2220,2100,2130,2045.532104,32743000,120,-90,2278.571429,2246.428571,2170,47.75931722,2060
EXCL.JK,2019-01-29,2130,2170,2040,2060,1978.308105,29299200,130,-70,2254.285714,2242.142857,2177.142857,72.07800008,2110
EXCL.JK,2019-01-30,2070,2120,2060,2110,2026.325195,16156100,60,40,2221.428571,2228.571429,2180.952381,100.0714031,2170
EXCL.JK,2019-01-31,2140,2170,2120,2170,2083.945801,11999900,50,30,2201.428571,2218.571429,2187.142857,107.1492062,2100
EXCL.JK,2019-02-01,2170,2190,2100,2100,2016.72168,10715500,90,-70,2187.142857,2216.428571,2196.190476,103.0718658,2120
EXCL.JK,2019-02-04,2110,2140,2090,2120,2035.928833,16082100,50,10,2155.714286,2215.714286,2200,88.29064557,2120
EXCL.JK,2019-02-05,2120,2120,2120,2120,2035.928833,0,0,0,2125.714286,2210.714286,2203.809524,43.53433237,2200
EXCL.JK,2019-02-06,2130,2220,2130,2200,2112.756104,40880800,90,70,2115.714286,2197.142857,2202.857143,33.09438163,2170
EXCL.JK,2019-02-07,2210,2230,2150,2170,2083.945801,28062500,80,-40,2125.714286,2190,2203.333333,46.13644361,2180
EXCL.JK,2019-02-08,2160,2210,2140,2180,2093.549316,21432400,70,20,2141.428571,2181.428571,2199.52381,38.04758925,2130
EXCL.JK,2019-02-11,2170,2200,2110,2130,2045.532104,23067700,90,-40,2151.428571,2176.428571,2196.190476,37.60699023,2070
EXCL.JK,2019-02-12,2130,2140,2040,2070,1987.911377,21694700,100,-60,2145.714286,2166.428571,2192.857143,37.35288604,2020
EXCL.JK,2019-02-13,2090,2110,1995,2020,1939.894287,15619400,115,-70,2141.428571,2148.571429,2190.952381,44.50789122,2050
EXCL.JK,2019-02-14,2050,2110,1995,2050,1968.704468,43970600,115,0,2127.142857,2126.428571,2182.857143,64.21689438,2340
EXCL.JK,2019-02-15,2050,2440,2050,2340,2247.204102,211910100,390,290,2117.142857,2116.428571,2170.47619,70.64330252,2530
EXCL.JK,2019-02-18,2360,2580,2360,2530,2429.669922,95862900,220,170,2137.142857,2131.428571,2172.380952,107.9682493,2610
EXCL.JK,2019-02-19,2560,2660,2510,2610,2506.496826,59416800,150,50,2188.571429,2165,2183.809524,184.7005298,2620
EXCL.JK,2019-02-20,2670,2670,2550,2620,2516.100586,30943600,120,-50,2250,2200.714286,2200.952381,243.5159132,2650
EXCL.JK,2019-02-21,2600,2680,2570,2650,2544.910645,16555400,110,50,2320,2232.857143,2217.619048,272.0294102,2640
EXCL.JK,2019-02-22,2650,2650,2570,2640,2535.307373,14537900,80,-10,2402.857143,2272.142857,2233.333333,271.5212874,2590
EXCL.JK,2019-02-25,2620,2620,2580,2590,2487.290283,11932100,40,-30,2491.428571,2309.285714,2248.095238,222.5180571,2500
EXCL.JK,2019-02-26,2560,2570,2410,2500,2400.859375,31258600,160,-60,2568.571429,2342.857143,2267.142857,108.2325539,2400
EXCL.JK,2019-02-27,2500,2530,2360,2400,2304.824951,22082600,170,-100,2591.428571,2364.285714,2284.761905,56.39993246,2400
EXCL.JK,2019-02-28,2400,2440,2330,2400,2304.824951,28718100,110,0,2572.857143,2380.714286,2300.952381,90.86882225,2490
EXCL.JK,2019-03-01,2410,2530,2390,2490,2391.256104,23691300,140,80,2542.857143,2396.428571,2314.761905,109.3487213,2450
EXCL.JK,2019-03-04,2510,2530,2420,2450,2352.842285,9909200,110,-60,2524.285714,2422.142857,2330,105.0170054,2400
EXCL.JK,2019-03-05,2450,2450,2380,2400,2304.824951,14575000,70,-50,2495.714286,2449.285714,2346.666667,91.44345117,2420
EXCL.JK,2019-03-06,2400,2430,2400,2420,2324.031738,3207900,30,20,2461.428571,2476.428571,2360,71.04659772,2420
EXCL.JK,2019-03-07,2420,2420,2420,2420,2324.031738,0,0,0,2437.142857,2502.857143,2374.285714,43.4796066,2350
EXCL.JK,2019-03-08,2410,2430,2310,2350,2256.807861,20327500,120,-60,2425.714286,2508.571429,2384.761905,33.59421719,2400
EXCL.JK,2019-03-11,2390,2450,2360,2400,2304.824951,11314900,90,10,2418.571429,2495.714286,2393.333333,43.75255095,2460
EXCL.JK,2019-03-12,2420,2480,2390,2460,2362.445557,11946700,90,40,2418.571429,2480.714286,2403.809524,43.75255095,2620
EXCL.JK,2019-03-13,2520,2670,2480,2620,2516.100586,35771200,190,100,2414.285714,2469.285714,2419.52381,36.44957378,2560
EXCL.JK,2019-03-14,2550,2580,2500,2560,2458.47998,8467900,80,10,2438.571429,2467.142857,2445.714286,86.49249899,2590
EXCL.JK,2019-03-15,2520,2630,2520,2590,2487.290283,12313300,110,70,2461.428571,2461.428571,2471.428571,95.29403119,2700
EXCL.JK,2019-03-18,2580,2720,2570,2700,2592.927979,21103300,150,120,2485.714286,2461.428571,2497.142857,104.2204623,2650
EXCL.JK,2019-03-19,2700,2730,2610,2650,2544.910645,10211800,120,-50,2525.714286,2475.714286,2514.285714,126.2084444,2700
EXCL.JK,2019-03-20,2650,2720,2610,2700,2592.927979,13744500,110,50,2568.571429,2493.571429,2520,105.8975246,2680
EXCL.JK,2019-03-21,2730,2760,2670,2680,2573.721191,10669000,90,-50,2611.428571,2515,2524.285714,84.93695141,2660
EXCL.JK,2019-03-22,2700,2720,2650,2660,2554.514404,2572000,70,-40,2642.857143,2528.571429,2527.142857,54.98917642,2590
EXCL.JK,2019-03-25,2660,2670,2550,2590,2487.290283,8303100,120,-70,2648.571429,2543.571429,2527.619048,54.29197959,2680
EXCL.JK,2019-03-26,2580,2700,2580,2680,2573.721191,8179200,120,100,2652.857143,2557.142857,2525.238095,46.80252333,2680
EXCL.JK,2019-03-27,2690,2710,2610,2680,2573.721191,5639200,100,-10,2665.714286,2575.714286,2529.52381,38.23486317,2680
EXCL.JK,2019-03-28,2700,2700,2610,2680,2573.721191,6086000,90,-20,2662.857143,2594.285714,2538.095238,35.9231985,2680
EXCL.JK,2019-03-29,2680,2700,2620,2680,2573.721191,2525300,80,0,2667.142857,2617.857143,2551.428571,35.9231985,2710
EXCL.JK,2019-04-01,2700,2750,2620,2710,2602.531494,8439600,130,10,2664.285714,2637.857143,2564.761905,33.59421719,2680
EXCL.JK,2019-04-02,2730,2730,2650,2680,2573.721191,4412800,80,-50,2668.571429,2655.714286,2575.238095,37.60699023,2680
EXCL.JK,2019-04-03,2680,2680,2680,2680,2573.721191,0,0,0,2671.428571,2660,2586.190476,37.60699023,2630
EXCL.JK,2019-04-04,2670,2700,2620,2630,2525.704102,4286200,80,-40,2684.285714,2668.571429,2599.52381,11.33893419,2640
EXCL.JK,2019-04-05,2640,2660,2570,2640,2535.307373,5133300,90,0,2677.142857,2671.428571,2609.52381,23.60387377,2530
EXCL.JK,2019-04-08,2620,2620,2510,2530,2429.669922,7210800,110,-90,2671.428571,2667.142857,2620,27.34262328,2550
EXCL.JK,2019-04-09,2530,2570,2520,2550,2448.876465,6235800,50,20,2650,2658.571429,2628.571429,59.44184833,2580
EXCL.JK,2019-04-10,2550,2610,2510,2580,2477.686768,5073500,100,30,2631.428571,2647.857143,2635.714286,68.17344826,2670
EXCL.JK,2019-04-11,2610,2730,2550,2670,2564.11792,12387200,180,60,2612.857143,2640.714286,2641.428571,60.47431568,2810
EXCL.JK,2019-04-12,2710,2890,2710,2810,2698.565674,25336100,180,100,2611.428571,2641.428571,2643.809524,58.71642911,2770
EXCL.JK,2019-04-15,2820,2840,2750,2770,2660.1521,10623500,90,-50,2630,2657.142857,2655.714286,93.98581453,2760
EXCL.JK,2019-04-16,2770,2800,2690,2760,2650.548828,19715400,110,-10,2650,2663.571429,2664.285714,107.8579312,2760
EXCL.JK,2019-04-17,2760,2760,2760,2760,2650.548828,0,0,0,2667.142857,2669.285714,2667.142857,115.2843276,2850
EXCL.JK,2019-04-18,2820,2880,2790,2850,2736.979492,33758200,90,30,2700,2675,2672.380952,101.6530045,2850
EXCL.JK,2019-04-19,2850,2850,2850,2850,2736.979492,0,0,0,2742.857143,2687.142857,2679.52381,90.50124966,2800
EXCL.JK,2019-04-22,2850,2880,2720,2800,2688.962646,34552200,160,-50,2781.428571,2697.142857,2687.619048,62.83008075,2930
EXCL.JK,2019-04-23,2770,2960,2770,2930,2813.807129,28490600,190,160,2800,2705.714286,2694.285714,39.15780041,2870
EXCL.JK,2019-04-24,2970,2980,2870,2870,2756.186523,11371700,110,-100,2817.142857,2723.571429,2710.47619,63.17021601,2860
EXCL.JK,2019-04-25,2870,2930,2830,2860,2746.583008,6940600,100,-10,2831.428571,2740.714286,2719.52381,62.029179,2870
EXCL.JK,2019-04-26,2830,2910,2820,2870,2756.186523,7321000,90,40,2845.714286,2756.428571,2728.095238,53.80741673,2900
EXCL.JK,2019-04-29,2870,2950,2870,2900,2784.996826,12936000,80,30,2861.428571,2780.714286,2737.142857,38.48314411,2920
EXCL.JK,2019-04-30,2900,2930,2870,2920,2804.203613,9537500,60,20,2868.571429,2805.714286,2747.619048,40.59087395,2920
EXCL.JK,2019-05-01,2920,2920,2920,2920,2804.203613,0,0,0,2878.571429,2830,2757.619048,43.75255095,2780
EXCL.JK,2019-05-02,2920,2920,2760,2780,2669.755371,11696900,160,-140,2895.714286,2847.857143,2769.047619,28.78491669,2780
EXCL.JK,2019-05-03,2800,2810,2640,2780,2669.755371,14894300,170,-20,2874.285714,2845.714286,2773.809524,48.25527358,2850
EXCL.JK,2019-05-06,2800,2880,2700,2850,2736.979492,21344400,180,50,2861.428571,2846.428571,2780.952381,60.11892975,2980
EXCL.JK,2019-05-07,2900,3070,2900,2980,2861.824219,43528900,170,80,2860,2852.857143,2790.952381,60.27713773,2960
EXCL.JK,2019-05-08,2970,3040,2940,2960,2842.617432,12287700,100,-10,2875.714286,2868.571429,2812.380952,75.68732674,2960
EXCL.JK,2019-05-09,2950,3020,2930,2960,2842.617432,11767700,90,10,2884.285714,2876.428571,2831.904762,82.02786983,2930
EXCL.JK,2019-05-10,2970,3000,2840,2930,2813.807129,15030400,160,-40,2890,2884.285714,2850,86.21678104,2760
EXCL.JK,2019-05-13,2940,2950,2720,2760,2650.548828,14260300,230,-180,2891.428571,2893.571429,2862.380952,86.87703406,2770
EXCL.JK,2019-05-14,2720,2810,2690,2770,2660.1521,15250000,120,50,2888.571429,2881.428571,2860,91.36530549,2650
EXCL.JK,2019-05-15,2780,2810,2530,2650,2544.910645,14982700,280,-130,2887.142857,2874.285714,2860,93.40133577,2560
EXCL.JK,2019-05-16,2650,2670,2550,2560,2458.47998,6731200,120,-90,2858.571429,2859.285714,2854.761905,130.0549334,2540
EXCL.JK,2019-05-17,2560,2600,2420,2540,2439.272949,7490000,180,-20,2798.571429,2837.142857,2845.238095,158.4748741,2650
EXCL.JK,2019-05-20,2520,2730,2450,2650,2544.910645,9392800,280,130,2738.571429,2811.428571,2830.47619,166.4760815,2670
EXCL.JK,2019-05-21,2650,2720,2620,2670,2564.11792,5280300,100,20,2694.285714,2792.142857,2820.952381,136.2420815,2640
EXCL.JK,2019-05-22,2670,2680,2580,2640,2535.307373,2000400,100,-30,2657.142857,2774.285714,2814.761905,88.26367424,2740
EXCL.JK,2019-05-23,2680,2790,2610,2740,2631.341553,10154800,180,60,2640,2764.285714,2800.952381,75.71877794,2790
EXCL.JK,2019-05-24,2760,2850,2740,2790,2679.359131,7215000,110,30,2635.714286,2761.428571,2794.761905,67.54187414,2810
EXCL.JK,2019-05-27,2830,2880,2810,2810,2698.565674,9575700,70,-20,2655.714286,2757.142857,2791.428571,89.60229589,2790
EXCL.JK,2019-05-28,2850,2860,2740,2790,2679.359131,4355000,120,-60,2691.428571,2745,2788.571429,94.76788687,2900
EXCL.JK,2019-05-29,2790,2920,2790,2900,2784.996826,9654100,130,110,2727.142857,2732.857143,2783.333333,72.73565969,2900
EXCL.JK,2019-05-30,2900,2900,2900,2900,2784.996826,0,0,0,2762.857143,2728.571429,2782.380952,88.26367424,2860
EXCL.JK,2019-05-31,2900,2980,2790,2860,2746.583008,20433200,190,-40,2795.714286,2726.428571,2781.428571,90.71147352,2860
EXCL.JK,2019-06-03,2860,2860,2860,2860,2746.583008,0,0,0,2827.142857,2733.571429,2785.238095,61.02302454,2860
EXCL.JK,2019-06-04,2860,2860,2860,2860,2746.583008,0,0,0,2844.285714,2740,2789.047619,47.90864322,2860
EXCL.JK,2019-06-05,2860,2860,2860,2860,2746.583008,0,0,0,2854.285714,2755,2789.52381,41.57609203,2860
EXCL.JK,2019-06-06,2860,2860,2860,2860,2746.583008,0,0,0,2861.428571,2776.428571,2783.809524,36.70993119,2860
EXCL.JK,2019-06-07,2860,2860,2860,2860,2746.583008,0,0,0,2871.428571,2799.285714,2779.047619,19.51800146,2940
EXCL.JK,2019-06-10,2950,3020,2910,2940,2823.410645,14450100,110,-10,2865.714286,2814.285714,2774.285714,15.11857892,2940
EXCL.JK,2019-06-11,2980,3000,2920,2940,2823.410645,5801400,80,-40,2871.428571,2833.571429,2774.761905,30.23715784,2900
EXCL.JK,2019-06-12,2980,2980,2860,2900,2784.996826,6123100,120,-80,2882.857143,2855,2783.333333,39.03600292,2860
EXCL.JK,2019-06-13,2850,2870,2810,2860,2746.583008,8567800,60,10,2888.571429,2866.428571,2789.52381,38.04758925,2860
EXCL.JK,2019-06-14,2860,2930,2840,2860,2746.583008,5537200,90,0,2888.571429,2871.428571,2799.52381,38.04758925,2850
EXCL.JK,2019-06-17,2900,2900,2820,2850,2736.979492,2026100,80,-50,2888.571429,2875,2813.809524,38.04758925,2910
EXCL.JK,2019-06-18,2850,2930,2850,2910,2794.600098,6053800,80,60,2887.142857,2879.285714,2828.571429,39.46064948,null
EXCL.JK,2019-06-19,null,null,null,null,null,null,#VALUE!,#VALUE!,2894.285714,2880,2840.952381,38.23486317,2990
EXCL.JK,2019-06-20,3050,3050,2980,2990,2871.427734,10083200,70,-60,2886.666667,2878.461538,2849.5,35.59026084,2900
EXCL.JK,2019-06-21,3000,3040,2850,2900,2784.996826,8630700,190,-100,2895,2888.461538,2867,52.44044241,2860
EXCL.JK,2019-06-24,2910,2950,2830,2860,2746.583008,2968700,120,-50,2895,2891.538462,2875,52.44044241,2860
EXCL.JK,2019-06-25,2830,2900,2830,2860,2746.583008,4768200,70,30,2895,2891.538462,2878.5,52.44044241,2920
EXCL.JK,2019-06-26,2870,2930,2870,2920,2804.203613,4080800,60,50,2895,2891.538462,2881,52.44044241,2920
EXCL.JK,2019-06-27,2930,2950,2890,2920,2804.203613,4830300,60,-10,2906.666667,2896.153846,2887.5,48.02776974,2980
EXCL.JK,2019-06-28,2950,3010,2910,2980,2861.824219,16338700,100,30,2908.333333,2900.769231,2888.5,48.33908012,2990
EXCL.JK,2019-07-01,3000,3040,2950,2990,2871.427734,7193000,90,-10,2918.571429,2903.846154,2892.5,51.77791403,2960
EXCL.JK,2019-07-02,3000,3010,2960,2960,2842.617432,4694000,50,-40,2918.571429,2907.692308,2899,51.77791403,2860
EXCL.JK,2019-07-03,2960,2990,2850,2860,2746.583008,7888800,140,-100,2927.142857,2912.307692,2904,53.13952883,2850
EXCL.JK,2019-07-04,2870,2900,2820,2850,2736.979492,7483000,80,-20,2927.142857,2912.307692,2904,53.13952883,2900
EXCL.JK,2019-07-05,2850,2920,2810,2900,2784.996826,8873400,110,50,2925.714286,2911.538462,2903.5,55.33448077,2860
EXCL.JK,2019-07-08,2920,2930,2850,2860,2746.583008,3213600,80,-60,2922.857143,2915.384615,2905.5,56.1884584,2930
EXCL.JK,2019-07-09,2890,2940,2870,2930,2813.807129,2796200,70,40,2914.285714,2911.538462,2905.5,61.06202935,2890
EXCL.JK,2019-07-10,2950,2950,2870,2890,2775.393311,4467600,80,-60,2907.142857,2912.857143,2905,54.68524655,2900
EXCL.JK,2019-07-11,2940,2940,2870,2900,2784.996826,4126000,70,-40,2892.857143,2905.714286,2902.5,40.70801957,2860
EXCL.JK,2019-07-12,2920,2920,2850,2860,2746.583008,5579900,70,-60,2884.285714,2905.714286,2902.5,28.78491669,2930
EXCL.JK,2019-07-15,2870,2940,2860,2930,2813.807129,7362100,80,60,2884.285714,2905.714286,2902.5,28.78491669,2940
EXCL.JK,2019-07-16,2930,2970,2910,2940,2823.410645,7216200,60,10,2895.714286,2910.714286,2906,28.78491669,2980
EXCL.JK,2019-07-17,2940,3020,2910,2980,2861.824219,9777300,110,40,2901.428571,2912.142857,2910.5,33.38091842,3110
EXCL.JK,2019-07-18,2980,3170,2970,3110,2986.669189,21650300,200,130,2918.571429,2916.428571,2914,38.91382421,3110
EXCL.JK,2019-07-19,3130,3150,3080,3110,2986.669189,10942200,70,-20,2944.285714,2925.714286,2923.333333,82.63517065,3100
EXCL.JK,2019-07-22,3110,3140,3080,3100,2977.065674,8278100,60,-10,2975.714286,2934.285714,2929.047619,98.80235201,3160
EXCL.JK,2019-07-23,3100,3220,3090,3160,3034.686035,17721600,130,60,3004.285714,2944.285714,2938.571429,102.1203771,3120
EXCL.JK,2019-07-24,3160,3200,3120,3120,2996.272217,7569800,80,-40,3047.142857,2965.714286,2952.857143,94.11239481,3250
EXCL.JK,2019-07-25,3120,3290,3010,3250,3121.116943,27474800,280,130,3074.285714,2985,2965.238095,81.21107126,3170
EXCL.JK,2019-07-26,3280,3300,3120,3170,3044.289551,14060600,180,-110,3118.571429,3010,2980.952381,80.29706749,3270
EXCL.JK,2019-07-29,3180,3340,3170,3270,3140.323975,9457500,170,90,3145.714286,3032.142857,2992.857143,53.18431563,3300
EXCL.JK,2019-07-30,3290,3420,3220,3300,3169.134277,47197900,200,10,3168.571429,3056.428571,3006.666667,67.68273326,3230
EXCL.JK,2019-07-31,3360,3360,3220,3230,3101.9104,14222200,140,-130,3195.714286,3085.714286,3021.428571,77.64387567,3280
EXCL.JK,2019-08-01,3230,3360,3180,3280,3149.92749,17978100,180,50,3214.285714,3109.285714,3034.285714,65.538066,3260
EXCL.JK,2019-08-02,3280,3280,3230,3260,3130.720459,10374400,50,-20,3231.428571,3139.285714,3054.285714,64.66028442,3130
EXCL.JK,2019-08-05,3220,3380,3050,3130,3005.875732,19561200,330,-90,3251.428571,3162.857143,3073.809524,42.20133151,3140
EXCL.JK,2019-08-06,3090,3240,3080,3140,3015.479248,17576600,160,50,3234.285714,3176.428571,3084.761905,62.41184259,3300
EXCL.JK,2019-08-07,3170,3310,3170,3300,3169.134277,11495800,140,130,3230,3187.857143,3098.095238,68.31300511,3350
EXCL.JK,2019-08-08,3320,3350,3280,3350,3217.151611,17136900,70,30,3234.285714,3201.428571,3115.714286,72.07800008,3310
EXCL.JK,2019-08-09,3390,3410,3260,3310,3178.737793,6504300,150,-80,3241.428571,3218.571429,3137.619048,81.53293229,3360
EXCL.JK,2019-08-12,3310,3400,3270,3360,3226.754883,8831500,130,50,3252.857143,3233.571429,3157.142857,85.18886581,3340
EXCL.JK,2019-08-13,3360,3450,3300,3340,3207.548096,13759200,150,-20,3264.285714,3247.857143,3180.952381,94.3145699,3360
EXCL.JK,2019-08-14,3400,3400,3300,3360,3226.754883,8527800,100,-40,3275.714286,3263.571429,3200.47619,98.46440014,3320
EXCL.JK,2019-08-15,3360,3360,3280,3320,3188.341064,11339100,80,-40,3308.571429,3271.428571,3220.47619,77.98046153,3250
EXCL.JK,2019-08-16,3300,3310,3180,3250,3121.116943,13561000,130,-50,3334.285714,3282.142857,3236.666667,24.39750182,3250
EXCL.JK,2019-08-19,3250,3280,3210,3250,3121.116943,12462100,70,0,3327.142857,3280.714286,3243.333333,39.03600292,3250
EXCL.JK,2019-08-20,3250,3310,3230,3250,3121.116943,10764600,80,0,3312.857143,3277.142857,3250,46.80252333,3270
EXCL.JK,2019-08-21,3250,3270,3210,3270,3140.323975,12651500,60,20,3304.285714,3278.571429,3257.142857,52.55382728,3350
EXCL.JK,2019-08-22,3290,3370,3280,3350,3217.151611,14523300,90,60,3291.428571,3277.857143,3262.380952,47.40906082,3330
EXCL.JK,2019-08-23,3380,3380,3250,3330,3197.94458,6255300,130,-50,3292.857143,3284.285714,3273.333333,49.23220007,3320
EXCL.JK,2019-08-26,3300,3340,3210,3320,3188.341064,7539300,130,20,3288.571429,3298.571429,3277.142857,43.3699479,3380
EXCL.JK,2019-08-27,3280,3400,3270,3380,3245.961914,11016600,130,100,3288.571429,3311.428571,3284.285714,43.3699479,3330
EXCL.JK,2019-08-28,3380,3400,3290,3330,3197.94458,7011500,110,-50,3307.142857,3317.142857,3289.52381,51.22313465,3390
EXCL.JK,2019-08-29,3300,3400,3300,3390,3255.565186,7206800,100,90,3318.571429,3315.714286,3290.952381,44.88079449,3480
EXCL.JK,2019-08-30,3400,3540,3390,3480,3341.996094,16924800,150,80,3338.571429,3321.428571,3298.571429,40.1781746,3620
EXCL.JK,2019-09-02,3500,3650,3480,3620,3476.444336,18483100,170,120,3368.571429,3330,3308.095238,55.80578567,3500
EXCL.JK,2019-09-03,3620,3660,3480,3500,3361.203125,8704600,180,-120,3407.142857,3350,3325.238095,108.8905086,3500
EXCL.JK,2019-09-04,3500,3550,3460,3500,3361.203125,13015700,90,0,3431.428571,3360,3342.857143,107.7695955,3520
EXCL.JK,2019-09-05,3530,3560,3480,3520,3380.409912,8878100,80,-10,3457.142857,3372.857143,3360,97.76064063,3270
EXCL.JK,2019-09-06,3570,3590,3150,3270,3140.323975,50259300,440,-300,3477.142857,3392.142857,3370.47619,93.57960706,3280
EXCL.JK,2019-09-09,3270,3390,3220,3280,3149.92749,28767900,170,10,3468.571429,3393.571429,3366.666667,110.5182596,3280
EXCL.JK,2019-09-10,3390,3600,3260,3280,3149.92749,30773800,340,-110,3452.857143,3395.714286,3365.238095,129.7066287,3270
EXCL.JK,2019-09-11,3280,3310,3230,3270,3140.323975,14896900,80,-10,3424.285714,3396.428571,3361.428571,143.974204,3350
EXCL.JK,2019-09-12,3290,3410,3280,3350,3217.151611,25527900,130,60,3374.285714,3390.714286,3358.095238,124.0775487,3450
EXCL.JK,2019-09-13,3360,3460,3360,3450,3313.186035,16207500,100,90,3352.857143,3392.142857,3357.619048,111.0126548,3380
EXCL.JK,2019-09-16,3450,3450,3310,3380,3245.961914,8829600,140,-70,3345.714286,3401.428571,3363.809524,101.1364001,3440
EXCL.JK,2019-09-17,3410,3480,3410,3440,3303.582275,15618500,70,30,3325.714286,3401.428571,3370,69.96597813,3500
EXCL.JK,2019-09-18,3470,3550,3460,3500,3361.203125,15169200,90,30,3350,3409.285714,3379.047619,76.59416862,3470
EXCL.JK,2019-09-19,3490,3550,3450,3470,3332.392822,6187000,100,-20,3381.428571,3417.142857,3390.952381,87.45066636,3410
EXCL.JK,2019-09-20,3480,3520,3370,3410,3274.772217,9784500,150,-70,3408.571429,3416.428571,3400.47619,79.88086367,3390
EXCL.JK,2019-09-23,3430,3470,3340,3390,3255.565186,6534300,130,-40,3428.571429,3401.428571,3403.333333,52.09880723,3290
EXCL.JK,2019-09-24,3420,3430,3260,3290,3159.530762,7695900,170,-130,3434.285714,3393.571429,3406.190476,43.53433237,3300
EXCL.JK,2019-09-25,3290,3330,3220,3300,3169.134277,6192200,110,10,3411.428571,3378.571429,3404.761905,68.66065623,3500
EXCL.JK,2019-09-26,3300,3510,3290,3500,3361.203125,14984500,220,200,3400,3362.857143,3400.952381,80.41558721,3500
EXCL.JK,2019-09-27,3490,3550,3440,3500,3361.203125,14775500,110,10,3408.571429,3379.285714,3409.047619,88.20970684,3440
EXCL.JK,2019-09-30,3460,3460,3380,3440,3303.582275,8336900,80,-20,3408.571429,3395,3414.285714,88.20970684,3450
EXCL.JK,2019-10-01,3440,3470,3390,3450,3313.186035,6286600,80,10,3404.285714,3406.428571,3412.380952,85.41216597,3450
EXCL.JK,2019-10-02,3410,3490,3410,3450,3313.186035,8620400,80,40,3410,3419.285714,3404.285714,87.17797887,3380
EXCL.JK,2019-10-03,3410,3420,3260,3380,3245.961914,10902400,160,-30,3418.571429,3426.428571,3401.904762,87.83100657,3350
EXCL.JK,2019-10-04,3390,3440,3320,3350,3217.151611,8835800,120,-40,3431.428571,3421.428571,3396.190476,70.81162132,3350
EXCL.JK,2019-10-07,3360,3380,3270,3350,3217.151611,7013200,110,-10,3438.571429,3419.285714,3388.095238,56.39993246,3450
EXCL.JK,2019-10-08,3310,3450,3310,3450,3313.186035,8264800,140,140,3417.142857,3412.857143,3391.904762,57.65248931,3440
EXCL.JK,2019-10-09,3450,3540,3430,3440,3303.582275,9908300,110,-10,3410,3409.285714,3400,47.95831523,3490
EXCL.JK,2019-10-10,3470,3500,3440,3490,3351.599365,8978700,60,20,3410,3407.142857,3407.619048,47.95831523,3490
EXCL.JK,2019-10-11,3450,3520,3440,3490,3351.599365,8844000,80,40,3415.714286,3412.857143,3418.095238,55.33448077,3490
EXCL.JK,2019-10-14,3530,3540,3450,3490,3351.599365,10066700,90,-40,3421.428571,3420,3424.761905,61.21780009,3530
EXCL.JK,2019-10-15,3500,3550,3500,3530,3390.013184,12183000,50,30,3437.142857,3434.285714,3426.666667,62.9058253,3530
EXCL.JK,2019-10-16,3550,3550,3400,3530,3390.013184,9894100,150,-20,3462.857143,3450.714286,3433.809524,57.94085654,3530
EXCL.JK,2019-10-17,3550,3550,3480,3530,3390.013184,7245900,70,-20,3488.571429,3452.857143,3438.095238,34.84660262,3540
EXCL.JK,2019-10-18,3540,3550,3480,3540,3399.616943,4672200,70,0,3500,3455,3439.52381,33.1662479,3500
EXCL.JK,2019-10-21,3490,3510,3450,3500,3361.203125,8987300,60,10,3514.285714,3462.142857,3442.857143,22.99068134,3520
EXCL.JK,2019-10-22,3500,3540,3470,3520,3380.409912,7836700,70,20,3515.714286,3465.714286,3447.142857,21.49196971,3480
EXCL.JK,2019-10-23,3510,3530,3470,3480,3341.996094,11054400,60,-30,3520,3470.714286,3453.333333,18.25741858,3450
EXCL.JK,2019-10-24,3470,3490,3440,3450,3313.186035,7440900,50,-20,3518.571429,3477.857143,3462.380952,21.15700942,3390
EXCL.JK,2019-10-25,3430,3520,3380,3390,3255.565186,11250900,140,-40,3507.142857,3485,3469.52381,32.51373336,3460
EXCL.JK,2019-10-28,3430,3550,3430,3460,3322.789307,12915400,120,30,3487.142857,3487.857143,3464.285714,52.82495803,3520
EXCL.JK,2019-10-29,3490,3540,3480,3520,3380.409912,10084300,60,30,3477.142857,3488.571429,3462.380952,49.90467103,3550
EXCL.JK,2019-10-30,3520,3560,3500,3550,3409.220215,18887100,60,30,3474.285714,3494.285714,3466.190476,46.13644361,3550
EXCL.JK,2019-10-31,3550,3550,3450,3550,3409.220215,10474300,100,0,3481.428571,3498.571429,3470.952381,53.98412465,3520
EXCL.JK,2019-11-01,3550,3550,3450,3520,3380.409912,9657500,100,-30,3485.714286,3502.857143,3475.714286,58.55400438,3550
EXCL.JK,2019-11-04,3520,3610,3520,3550,3409.220215,26170300,90,30,3491.428571,3505,3482.380952,59.84105932,3500
EXCL.JK,2019-11-05,3550,3560,3470,3500,3361.203125,17822800,90,-50,3505.714286,3506.428571,3491.904762,60.23762469,3520
EXCL.JK,2019-11-06,3510,3580,3500,3520,3380.409912,11876400,80,10,3521.428571,3504.285714,3499.047619,33.38091842,3500
EXCL.JK,2019-11-07,3550,3550,3450,3500,3361.203125,9760400,100,-50,3530,3503.571429,3502.380952,20,3450
EXCL.JK,2019-11-08,3630,3730,3420,3450,3313.186035,71413500,310,-180,3527.142857,3500.714286,3505.238095,22.88688541,3300
EXCL.JK,2019-11-11,3450,3500,3260,3300,3169.134277,21046300,240,-150,3512.857143,3497.142857,3503.333333,34.50327797,3460
EXCL.JK,2019-11-12,3340,3480,3320,3460,3322.789307,25200300,160,120,3477.142857,3481.428571,3494.285714,83.80817098,3440
EXCL.JK,2019-11-13,3460,3510,3410,3440,3303.582275,17493000,100,-20,3468.571429,3480,3492.857143,81.73709305,3480
EXCL.JK,2019-11-14,3490,3530,3440,3480,3341.996094,22803200,90,-10,3452.857143,3479.285714,3488.571429,73.64651739,3480
EXCL.JK,2019-11-15,3500,3520,3460,3480,3341.996094,19547400,60,-20,3450,3485.714286,3486.190476,71.87952884,3480
EXCL.JK,2019-11-18,3500,3540,3400,3480,3341.996094,19152500,140,-20,3444.285714,3487.142857,3483.809524,66.79749069,3530
EXCL.JK,2019-11-19,3530,3550,3490,3530,3390.013184,20500100,60,0,3441.428571,3484.285714,3480.952381,64.40201121,3550
EXCL.JK,2019-11-20,3550,3550,3500,3550,3409.220215,10459700,50,0,3452.857143,3482.857143,3482.380952,72.73565969,3500
EXCL.JK,2019-11-21,3550,3550,3460,3500,3361.203125,23152800,90,-50,3488.571429,3482.857143,3483.809524,38.48314411,3540
EXCL.JK,2019-11-22,3530,3580,3510,3540,3399.616943,40647700,70,10,3494.285714,3481.428571,3484.761905,36.44957378,3550
EXCL.JK,2019-11-25,3550,3590,3510,3550,3409.220215,36810500,80,0,3508.571429,3480.714286,3489.047619,30.78342164,3490
EXCL.JK,2019-11-26,3550,3550,3470,3490,3351.599365,218231500,80,-60,3518.571429,3484.285714,3496.666667,31.32015934,3390
EXCL.JK,2019-11-27,3490,3490,3300,3390,3255.565186,22229100,190,-100,3520,3482.142857,3498.095238,29.43920289,3230
EXCL.JK,2019-11-28,3350,3360,3180,3230,3101.9104,16174300,180,-120,3507.142857,3474.285714,3491.904762,56.77860093,3340
EXCL.JK,2019-11-29,3180,3350,3070,3340,3207.548096,8546700,280,160,3464.285714,3458.571429,3476.666667,117.4531315,3390
EXCL.JK,2019-12-02,3360,3410,3350,3390,3255.565186,9834600,60,30,3434.285714,3461.428571,3466.666667,118.7233679,3420
EXCL.JK,2019-12-03,3400,3430,3380,3420,3284.375488,13072800,50,20,3418.571429,3456.428571,3460.47619,115.8200575,3410
EXCL.JK,2019-12-04,3420,3430,3380,3410,3274.772217,10036900,50,-10,3401.428571,3455,3454.285714,103.0256556,3350
EXCL.JK,2019-12-05,3370,3400,3300,3350,3217.151611,10002900,100,-20,3381.428571,3450,3450,80.5043625,3400
EXCL.JK,2019-12-06,3390,3400,3300,3400,3265.168457,10281300,100,10,3361.428571,3440.714286,3441.904762,64.9175301,3270
EXCL.JK,2019-12-09,3390,3390,3250,3270,3140.323975,7995800,140,-120,3362.857143,3435,3437.142857,65.75568054,3300
EXCL.JK,2019-12-10,3270,3340,3260,3300,3169.134277,9858500,80,30,3368.571429,3416.428571,3428.571429,52.734736,3300
EXCL.JK,2019-12-11,3290,3320,3270,3300,3169.134277,6693500,50,10,3362.857143,3398.571429,3428.571429,58.22779569,3260
EXCL.JK,2019-12-12,3300,3300,3240,3260,3130.720459,9334700,60,-40,3350,3384.285714,3420.952381,61.10100927,3240
EXCL.JK,2019-12-13,3310,3310,3220,3240,3111.513672,10939400,90,-70,3327.142857,3364.285714,3412.380952,60.47431568,3210
EXCL.JK,2019-12-16,3220,3280,3190,3210,3082.703369,8656200,90,-10,3302.857143,3342.142857,3400.952381,55.5920515,3310
EXCL.JK,2019-12-17,3210,3310,3200,3310,3178.737793,7381000,110,100,3282.857143,3322.142857,3388.095238,60.74928963,3330
EXCL.JK,2019-12-18,3310,3360,3260,3330,3197.94458,12475400,100,20,3270,3316.428571,3380,36.51483717,3220
EXCL.JK,2019-12-19,3330,3350,3220,3220,3092.306641,4637100,130,-110,3278.571429,3323.571429,3370.47619,42.98393941,3320
EXCL.JK,2019-12-20,3250,3320,3220,3320,3188.341064,11562300,100,70,3267.142857,3315,3354.761905,46.80252333,3310
EXCL.JK,2019-12-23,3330,3350,3250,3310,3178.737793,5436300,100,-20,3270,3310,3346.190476,49.66554809,3260
EXCL.JK,2019-12-26,3250,3300,3250,3260,3130.720459,3863700,50,10,3277.142857,3302.142857,3335.238095,51.54748158,3250
EXCL.JK,2019-12-27,3270,3270,3220,3250,3121.116943,4899800,50,-20,3280,3291.428571,3321.428571,49.66554809,3150
EXCL.JK,2019-12-30,3220,3250,3150,3150,3025.082764,5075500,100,-70,3285.714286,3284.285714,3310,41.97504928,3210
EXCL.JK,2020-01-02,3170,3220,3140,3210,3082.703369,3718200,80,40,3262.857143,3266.428571,3298.571429,64.21689438,3200
EXCL.JK,2020-01-03,3230,3230,3190,3200,3073.099854,3907700,40,-30,3245.714286,3262.142857,3297.619048,59.12053869,3240
EXCL.JK,2020-01-06,3170,3250,3160,3240,3111.513672,3513500,90,70,3242.857143,3255,3290.952381,61.02302454,3250
EXCL.JK,2020-01-07,3250,3270,3220,3250,3121.116943,3419200,50,0,3231.428571,3250.714286,3283.809524,50.80307452,3300
EXCL.JK,2020-01-08,3250,3300,3190,3300,3169.134277,6944000,110,50,3222.857143,3250,3275.714286,39.03600292,3290
EXCL.JK,2020-01-09,3300,3310,3220,3290,3159.530762,9408900,90,-10,3228.571429,3254.285714,3270.47619,47.40906082,3290
EXCL.JK,2020-01-10,3260,3290,3230,3290,3159.530762,7746400,60,30,3234.285714,3260,3267.619048,52.55382728,3310
EXCL.JK,2020-01-13,3290,3310,3250,3310,3178.737793,9256500,60,20,3254.285714,3258.571429,3262.380952,40.35556255,3330
EXCL.JK,2020-01-14,3320,3330,3270,3330,3197.94458,10518100,60,10,3268.571429,3257.142857,3264.285714,39.7611919,3250
EXCL.JK,2020-01-15,3300,3350,3230,3250,3121.116943,11805100,120,-50,3287.142857,3265,3265.714286,31.99702367,3330
EXCL.JK,2020-01-16,3250,3340,3210,3330,3197.94458,7904800,130,80,3288.571429,3260,3263.333333,29.68084199,3360
EXCL.JK,2020-01-17,3300,3390,3290,3360,3226.754883,7431600,100,60,3300,3261.428571,3266.666667,27.68874621,3360
EXCL.JK,2020-01-20,3360,3380,3340,3360,3226.754883,4466800,40,0,3308.571429,3268.571429,3272.380952,35.79039509,3300
EXCL.JK,2020-01-21,3330,3330,3260,3300,3169.134277,4644000,70,-30,3318.571429,3276.428571,3279.52381,39.33978962,3200
EXCL.JK,2020-01-22,3280,3280,3180,3200,3073.099854,5932000,100,-80,3320,3287.142857,3279.047619,38.29708431,3220
EXCL.JK,2020-01-23,3200,3240,3180,3220,3092.306641,3442100,60,20,3304.285714,3286.428571,3272.857143,59.68169537,3190
EXCL.JK,2020-01-24,3200,3270,3170,3190,3063.496582,4855800,100,-10,3288.571429,3287.857143,3272.857143,65.93647737,3060
EXCL.JK,2020-01-27,3160,3210,3040,3060,2938.651855,7645600,170,-100,3280,3284.285714,3266.666667,75.05553499,3050
EXCL.JK,2020-01-28,3000,3090,3000,3050,2929.048096,8042100,90,50,3241.428571,3270.714286,3254.761905,107.4598485,3010
EXCL.JK,2020-01-29,3070,3080,3000,3010,2890.634766,3538400,80,-60,3197.142857,3252.857143,3244.761905,114.1219064,2940
EXCL.JK,2020-01-30,3050,3050,2900,2940,2823.410645,6612800,150,-110,3147.142857,3232.857143,3233.333333,107.349008,2900
EXCL.JK,2020-01-31,2990,2990,2840,2900,2784.996826,12812900,150,-90,3095.714286,3207.857143,3223.333333,108.1445241,2840
EXCL.JK,2020-02-03,2950,2950,2810,2840,2727.376465,6528100,140,-110,3052.857143,3178.571429,3208.571429,118.8436348,2840
EXCL.JK,2020-02-04,2810,2900,2810,2840,2727.376465,15726100,90,30,2998.571429,3143.571429,3191.428571,116.5373433,2890
EXCL.JK,2020-02-05,2850,2910,2830,2890,2775.393311,25188300,80,40,2948.571429,3114.285714,3172.380952,93.52870708,2890
EXCL.JK,2020-02-06,2900,2950,2870,2890,2775.393311,30048700,80,-10,2924.285714,3082.857143,3155.238095,81.00558476,2900
EXCL.JK,2020-02-07,2890,2930,2860,2900,2784.996826,39432100,70,10,2901.428571,3049.285714,3135.714286,59.2814112,2800
EXCL.JK,2020-02-10,2900,2900,2700,2800,2688.962646,26809000,200,-100,2885.714286,3016.428571,3117.142857,35.52329886,2860
EXCL.JK,2020-02-11,2840,2880,2790,2860,2746.583008,28109900,90,20,2865.714286,2980.714286,3093.809524,39.0969491,2860
EXCL.JK,2020-02-12,2880,2880,2790,2860,2746.583008,14918400,90,-20,2860,2956.428571,3072.380952,36.05551275,2710
EXCL.JK,2020-02-13,2850,2860,2650,2710,2602.531494,16894300,210,-140,2862.857143,2930.714286,3050,34.98298906,2620
EXCL.JK,2020-02-14,2700,2700,2550,2620,2516.100586,25077200,150,-80,2844.285714,2896.428571,3024.285714,68.03360514,2650
EXCL.JK,2020-02-17,2610,2670,2560,2650,2544.910645,17448000,110,40,2805.714286,2865,2990.47619,104.5398079,2720
EXCL.JK,2020-02-18,2650,2760,2630,2720,2612.13501,11817200,130,70,2771.428571,2836.428571,2956.666667,111.4194135,2760
EXCL.JK,2020-02-19,2720,2770,2670,2760,2650.548828,7839900,100,40,2745.714286,2815.714286,2926.190476,96.58452997,2680
EXCL.JK,2020-02-20,2750,2790,2660,2680,2573.721191,14956100,130,-70,2740,2802.857143,2900.47619,93.98581453,2600
EXCL.JK,2020-02-21,2660,2670,2580,2600,2496.893799,13942600,90,-60,2714.285714,2787.142857,2875.714286,79.13219801,2520
EXCL.JK,2020-02-24,2550,2560,2510,2520,2420.066162,13293200,50,-30,2677.142857,2770,2846.190476,57.36267245,2580
EXCL.JK,2020-02-25,2480,2600,2430,2580,2477.686768,13474300,170,100,2650,2747.142857,2814.285714,79.79139469,2540
EXCL.JK,2020-02-26,2580,2600,2500,2540,2439.272949,12914700,100,-40,2644.285714,2725,2791.428571,83.63753999,2460
EXCL.JK,2020-02-27,2500,2550,2420,2460,2362.445557,9745400,130,-40,2628.571429,2700,2767.142857,92.27288721,2590
EXCL.JK,2020-02-28,2380,2590,2290,2590,2487.290283,30542000,300,210,2591.428571,2668.571429,2740.952381,101.2305243,2520
EXCL.JK,2020-03-02,2600,2610,2430,2520,2420.066162,11254300,180,-80,2567.142857,2653.571429,2724.285714,69.45365018,2500
EXCL.JK,2020-03-03,2530,2570,2450,2500,2400.859375,15310400,120,-30,2544.285714,2629.285714,2706.190476,49.61758521,2540
EXCL.JK,2020-03-04,2500,2570,2450,2540,2439.272949,12409200,120,40,2530,2603.571429,2690,45.09249753,2480
EXCL.JK,2020-03-05,2540,2580,2440,2480,2381.652344,10332200,140,-60,2532.857143,2591.428571,2675.714286,44.98677054,2310
EXCL.JK,2020-03-06,2450,2450,2300,2310,2218.394043,22686000,150,-140,2518.571429,2581.428571,2656.190476,43.3699479,2100
EXCL.JK,2020-03-09,2240,2240,2100,2100,2016.72168,19039800,140,-140,2485.714286,2557.142857,2628.571429,88.29064557,2130
EXCL.JK,2020-03-10,1995,2200,1995,2130,2045.532104,19489400,205,135,2434.285714,2512.857143,2590.47619,171.4503954,1995
EXCL.JK,2020-03-11,2100,2190,1935,1995,1915.885742,24564900,255,-105,2368.571429,2467.857143,2558.571429,189.0704076,1865
EXCL.JK,2020-03-12,1890,1925,1810,1865,1791.041016,15832400,115,-25,2293.571429,2418.928571,2517.380952,220.5053719,1800
EXCL.JK,2020-03-13,1790,1880,1735,1800,1728.618652,20056500,145,10,2202.857143,2366.428571,2470,250.0642775,1675
EXCL.JK,2020-03-16,1800,1800,1675,1675,1608.575806,9633300,125,-125,2097.142857,2315,2426.666667,239.9975198,1575
EXCL.JK,2020-03-17,1660,1670,1560,1575,1512.541382,27694000,110,-85,1982.142857,2250.357143,2381.666667,217.8083474,1515
EXCL.JK,2020-03-18,1600,1615,1465,1515,1454.920776,18421000,150,-85,1877.142857,2181.428571,2330.47619,210.4530261,1410
EXCL.JK,2020-03-19,1500,1500,1410,1410,1354.084595,4997000,90,-90,1793.571429,2113.928571,2273.095238,222.9856925,1595
EXCL.JK,2020-03-20,1410,1595,1315,1595,1531.748291,43914600,280,185,1690.714286,2029.642857,2208.809524,207.4533797,1485
EXCL.JK,2020-03-23,1550,1550,1485,1485,1426.110474,16354800,65,-65,1633.571429,1963.571429,2157.142857,159.1308237,1410
EXCL.JK,2020-03-24,1480,1595,1385,1410,1354.084595,37792500,210,-70,1579.285714,1891.071429,2104.047619,128.984126,1760
EXCL.JK,2020-03-26,1470,1760,1435,1760,1690.204956,49825000,325,290,1523.571429,1810.357143,2051.190476,98.34947406,1800
EXCL.JK,2020-03-27,1800,2090,1760,1800,1728.618652,33266600,330,0,1535.714286,1758.928571,2012.142857,122.4550452,1800
EXCL.JK,2020-03-30,1825,1845,1675,1800,1728.618652,23104200,170,-25,1567.857143,1722.5,1976.904762,158.662565,2000
EXCL.JK,2020-03-31,1850,2130,1850,2000,1920.687378,15755800,280,150,1608.571429,1701.071429,1945.47619,178.2019988,1950
EXCL.JK,2020-04-01,1990,2100,1895,1950,1872.670288,12908300,205,-40,1692.857143,1691.785714,1917.380952,205.9906378,2050
EXCL.JK,2020-04-02,2000,2080,1910,2050,1968.704468,10830400,170,50,1743.571429,1688.571429,1890.238095,221.0338263,2150
EXCL.JK,2020-04-03,2080,2160,2030,2150,2064.739014,16417900,130,70,1824.285714,1701.785714,1868.809524,213.9203234,2380
EXCL.JK,2020-04-06,2150,2430,2150,2380,2285.61792,17230100,280,230,1930,1726.785714,1850.238095,147.6482306,2280
EXCL.JK,2020-04-07,2450,2580,2230,2280,2189.58374,26475200,350,-170,2018.571429,1777.142857,1845.47619,203.9140809,2210
EXCL.JK,2020-04-08,2260,2260,2130,2210,2122.359619,17191900,130,-50,2087.142857,1827.5,1844.047619,198.8059595,2150
EXCL.JK,2020-04-09,2210,2310,2110,2150,2064.739014,13564400,200,-60,2145.714286,1877.142857,1849.285714,155.8692981,2170
EXCL.JK,2020-04-13,2180,2200,2120,2170,2083.945801,6483900,80,-10,2167.142857,1930,1850.238095,142.210441,2270
EXCL.JK,2020-04-14,2170,2330,2170,2270,2179.980225,14478900,160,100,2198.571429,1971.071429,1858.571429,105.8975246,2230
EXCL.JK,2020-04-15,2340,2430,2220,2230,2141.566406,17678000,210,-110,2230,2027.142857,1877.857143,85.04900548,2120
EXCL.JK,2020-04-16,2230,2250,2110,2120,2035.928833,16145900,140,-110,2241.428571,2085.714286,1898.333333,77.55182599,2400
EXCL.JK,2020-04-17,2180,2410,2180,2400,2304.824951,14347300,230,220,2204.285714,2111.428571,1919.52381,60.51367417,2350
EXCL.JK,2020-04-20,2420,2480,2300,2350,2256.807861,14988800,180,-70,2221.428571,2154.285714,1958.809524,93.52870708,2300
EXCL.JK,2020-04-21,2350,2350,2260,2300,2208.790283,14017300,90,-50,2241.428571,2193.571429,1998.571429,104.9489672,2560
EXCL.JK,2020-04-22,2280,2670,2240,2560,2458.47998,22452100,430,280,2262.857143,2215,2040.952381,98.27076298,2410
EXCL.JK,2020-04-23,2560,2600,2410,2410,2314.428467,15180600,190,-150,2318.571429,2258.571429,2086.904762,138.9758458,2380
EXCL.JK,2020-04-24,2400,2550,2360,2380,2285.61792,13346800,190,-20,2338.571429,2284.285714,2130.952381,140.8815781,2480
EXCL.JK,2020-04-27,2420,2520,2410,2480,2381.652344,12819400,110,60,2360,2300.714286,2177.142857,132.7905619,2550
EXCL.JK,2020-04-28,2510,2600,2460,2550,2448.876465,12994700,140,40,2411.428571,2307.857143,2211.428571,85.71825388,2590
EXCL.JK,2020-04-29,2500,2730,2500,2590,2487.290283,21013300,230,90,2432.857143,2327.142857,2247.142857,99.95236961,2540
EXCL.JK,2020-04-30,2620,2690,2540,2540,2439.272949,19337500,150,-80,2467.142857,2354.285714,2284.761905,107.6590739,2450
EXCL.JK,2020-05-04,2560,2560,2430,2450,2352.842285,18170500,130,-110,2501.428571,2382.142857,2310.47619,80.29706749,2420
EXCL.JK,2020-05-05,2470,2510,2390,2420,2324.031738,13024700,120,-50,2485.714286,2402.142857,2334.285714,77.64387567,2320
EXCL.JK,2020-05-06,2440,2440,2300,2320,2227.997559,22750500,140,-120,2487.142857,2412.857143,2351.904762,76.0951785,2380
EXCL.JK,2020-05-08,2350,2430,2340,2380,2285.61792,15509100,90,30,2478.571429,2419.285714,2360,91.91092997,2400
EXCL.JK,2020-05-11,2380,2530,2380,2400,2304.824951,34528100,150,20,2464.285714,2437.857143,2360,99.13915185,2290
EXCL.JK,2020-05-12,2450,2450,2280,2290,2199.187256,39079300,170,-160,2442.857143,2437.857143,2365.714286,93.57960706,2400
EXCL.JK,2020-05-13,2280,2430,2250,2400,2304.824951,22512700,180,120,2400,2433.571429,2369.52381,83.06623863,2350
EXCL.JK,2020-05-14,2400,2450,2350,2350,2256.807861,8810500,100,-50,2380,2440.714286,2381.428571,56.27314339,2460
EXCL.JK,2020-05-15,2380,2470,2350,2460,2362.445557,16102900,120,80,2365.714286,2425.714286,2390,47.55948656,2510
EXCL.JK,2020-05-18,2460,2570,2450,2510,2410.462646,19642400,120,50,2371.428571,2429.285714,2399.047619,56.69467095,2480
EXCL.JK,2020-05-19,2560,2580,2420,2480,2381.652344,22573900,160,-80,2398.571429,2438.571429,2412.380952,71.51423435,2400
EXCL.JK,2020-05-20,2470,2500,2380,2400,2304.824951,15726700,120,-70,2412.857143,2438.571429,2429.52381,76.96628823,2430
EXCL.JK,2020-05-26,2420,2510,2400,2430,2333.635254,20617900,110,10,2412.857143,2427.857143,2429.52381,76.96628823,2630
EXCL.JK,2020-05-27,2460,2660,2430,2630,2525.704102,21257300,230,170,2432.857143,2416.428571,2433.333333,54.68524655,2490
EXCL.JK,2020-05-28,2630,2660,2490,2490,2391.256104,24822200,170,-140,2465.714286,2422.857143,2449.047619,89.60229589,2590
EXCL.JK,2020-05-29,2500,2590,2450,2590,2487.290283,39056100,140,90,2485.714286,2425.714286,2445.714286,73.67883976,2570
EXCL.JK,2020-06-02,2590,2650,2530,2570,2487.290283,15722700,120,-20,2504.285714,2437.857143,2454.285714,82.02786983,2580
EXCL.JK,2020-06-03,2590,2600,2540,2580,2496.968262,11365900,60,-10,2512.857143,2455.714286,2463.333333,85.77378887,2650
EXCL.JK,2020-06-04,2590,2670,2580,2650,2564.71582,27762400,90,60,2527.142857,2470,2468.095238,87.69536014,2730
EXCL.JK,2020-06-05,2650,2750,2610,2730,2642.141113,20842500,140,80,2562.857143,2487.857143,2472.857143,77.61320457,2700
EXCL.JK,2020-06-08,2760,2810,2690,2700,2613.106689,15718800,120,-60,2605.714286,2519.285714,2479.52381,74.80132415,2650
EXCL.JK,2020-06-09,2730,2750,2640,2650,2564.71582,10685100,110,-80,2615.714286,2540.714286,2487.142857,82.83661486,2640
EXCL.JK,2020-06-10,2660,2760,2550,2640,2555.037354,19467600,210,-20,2638.571429,2562.142857,2496.666667,61.75990377,2550
EXCL.JK,2020-06-11,2640,2650,2530,2550,2467.933838,11626200,120,-90,2645.714286,2575,2507.142857,57.98193479,2560
EXCL.JK,2020-06-12,2470,2580,2430,2560,2477.612305,11645400,150,90,2642.857143,2577.857143,2518.095238,62.64031868,2530
EXCL.JK,2020-06-15,2550,2620,2490,2530,2448.577637,16195500,130,-20,2640,2583.571429,2526.666667,66.33249581,2610
EXCL.JK,2020-06-16,2560,2620,2550,2610,2526.00293,16326800,70,50,2622.857143,2592.857143,2532.857143,77.82764841,2690
EXCL.JK,2020-06-17,2650,2700,2610,2690,2603.428223,14320500,90,40,2605.714286,2605.714286,2548.095238,61.87545094,2750
EXCL.JK,2020-06-18,2700,2750,2630,2750,2661.497314,9497600,120,50,2604.285714,2610,2561.904762,59.40177968,2790
EXCL.JK,2020-06-19,2730,2800,2710,2790,2700.210205,16779000,90,60,2618.571429,2628.571429,2580.952381,80.5043625,2720
EXCL.JK,2020-06-22,2790,2810,2660,2720,2632.462891,9454900,150,-70,2640,2642.857143,2596.666667,103.7625494,2690
EXCL.JK,2020-06-23,2760,2770,2640,2690,2603.428223,7044600,130,-70,2664.285714,2653.571429,2606.666667,98.97089519,2690
EXCL.JK,2020-06-24,2690,2750,2670,2690,2603.428223,7548000,80,0,2682.857143,2661.428571,2616.666667,87.69536014,2640
EXCL.JK,2020-06-25,2690,2690,2630,2640,2555.037354,8159900,60,-50,2705.714286,2664.285714,2630.47619,56.52643714,2750
EXCL.JK,2020-06-26,2690,2780,2660,2750,2661.497314,10432300,120,60,2710,2657.857143,2640.47619,48.6483984,2770
EXCL.JK,2020-06-29,2750,2820,2690,2770,2680.85376,9168700,130,20,2718.571429,2661.428571,2646.190476,49.80915961,2770
EXCL.JK,2020-06-30,2800,2820,2730,2770,2680.85376,9112600,90,-30,2721.428571,2670,2659.52381,52.417736,2730
EXCL.JK,2020-07-01,2800,2800,2700,2730,2642.141113,4448900,100,-70,2718.571429,2679.285714,2668.095238,48.4522347,2720
EXCL.JK,2020-07-02,2730,2750,2710,2720,2632.462891,5566100,40,-10,2720,2692.142857,2675.714286,48.6483984,2770
EXCL.JK,2020-07-03,2730,2790,2720,2770,2680.85376,4611100,70,40,2724.285714,2703.571429,2682.380952,46.85336802,2950
EXCL.JK,2020-07-06,2790,3070,2770,2950,2855.060791,24444700,300,160,2735.714286,2720.714286,2688.095238,46.85336802,2900
EXCL.JK,2020-07-07,2980,2980,2870,2900,2806.670166,15060700,110,-80,2780,2745,2698.571429,77.67453465,2960
EXCL.JK,2020-07-08,2910,2980,2890,2960,2864.739014,8637100,90,50,2801.428571,2760,2708.095238,88.02056037,2920
EXCL.JK,2020-07-09,2970,3010,2900,2920,2826.026123,9827200,110,-50,2828.571429,2775,2722.857143,104.4714589,2860
EXCL.JK,2020-07-10,2900,2930,2860,2860,2767.957275,4576800,70,-40,2850,2784.285714,2736.190476,105.8300524,2940
EXCL.JK,2020-07-13,2870,2960,2870,2940,2845.382568,5843900,90,70,2868.571429,2794.285714,2750.952381,91.72941575,2970
EXCL.JK,2020-07-14,2930,2970,2900,2970,2874.417236,4121300,70,40,2900,2812.142857,2769.047619,66.58328118,2930
EXCL.JK,2020-07-15,2970,2990,2910,2930,2835.70459,5143600,80,-40,2928.571429,2832.142857,2790,38.48314411,2870
EXCL.JK,2020-07-16,2930,2960,2870,2870,2777.635254,6349200,90,-60,2925.714286,2852.857143,2805.238095,37.35288604,2850
EXCL.JK,2020-07-17,2850,2900,2780,2850,2758.279053,5311100,120,0,2921.428571,2861.428571,2813.809524,42.20133151,2870
EXCL.JK,2020-07-20,2850,2890,2830,2870,2777.635254,3809200,60,20,2905.714286,2867.142857,2818.571429,45.77377082,2840
EXCL.JK,2020-07-21,2870,2900,2840,2840,2748.60083,9268000,60,-30,2898.571429,2874.285714,2822.380952,47.05619741,2800
EXCL.JK,2020-07-22,2900,2920,2790,2800,2709.888184,11019600,130,-100,2895.714286,2882.142857,2828.095238,50.28490259,2820
EXCL.JK,2020-07-23,2810,2870,2800,2820,2729.244629,10565300,70,10,2875.714286,2887.857143,2833.333333,57.11308748,2760
EXCL.JK,2020-07-24,2830,2860,2740,2760,2671.175537,11446400,120,-70,2854.285714,2891.428571,2839.52381,41.97504928,2800
EXCL.JK,2020-07-27,2800,2820,2770,2800,2709.888184,5974800,50,0,2830,2877.857143,2845.238095,40,2730
EXCL.JK,2020-07-28,2820,2840,2710,2730,2642.141113,14211600,130,-90,2820,2870.714286,2847.619048,36.96845502,2540
EXCL.JK,2020-07-29,2700,2710,2540,2540,2458.255859,57573700,170,-160,2802.857143,2854.285714,2845.714286,47.15728495,2500
EXCL.JK,2020-07-30,2540,2560,2410,2500,2419.543213,60590100,150,-40,2755.714286,2827.142857,2834.761905,101.9570404,2380
EXCL.JK,2020-08-03,2500,2510,2330,2380,2303.405029,38058800,180,-120,2707.142857,2801.428571,2823.809524,131.7465098,2440
EXCL.JK,2020-08-04,2380,2450,2340,2440,2361.473877,36354000,110,60,2647.142857,2761.428571,2807.619048,171.9219092,2480
EXCL.JK,2020-08-05,2440,2480,2380,2480,2400.186768,32538000,100,40,2592.857143,2723.571429,2791.904762,168.1977294,2530
EXCL.JK,2020-08-06,2510,2550,2480,2530,2448.577637,20712500,70,20,2552.857143,2691.428571,2769.52381,154.5654431,2440
EXCL.JK,2020-08-07,2530,2560,2410,2440,2361.473877,26103200,150,-90,2514.285714,2667.142857,2751.904762,109.8267033,2450
EXCL.JK,2020-08-10,2450,2470,2400,2450,2371.152344,6831200,70,0,2472.857143,2637.857143,2727.142857,56.77860093,2410
EXCL.JK,2020-08-11,2460,2470,2380,2410,2332.439453,17850500,90,-50,2460,2607.857143,2704.761905,48.6483984,2430
EXCL.JK,2020-08-12,2430,2450,2410,2430,2351.795898,9634000,40,0,2447.142857,2577.142857,2683.333333,48.20590756,2610
EXCL.JK,2020-08-13,2460,2610,2440,2610,2526.00293,58717500,170,150,2454.285714,2550.714286,2659.047619,39.5209408,2550
EXCL.JK,2020-08-14,2610,2640,2530,2550,2467.933838,47890100,110,-60,2478.571429,2535.714286,2641.904762,69.8638131,2520
EXCL.JK,2020-08-18,2550,2570,2510,2520,2438.899414,19770700,60,-30,2488.571429,2520.714286,2623.809524,74.92853738,2520
EXCL.JK,2020-08-19,2520,2580,2510,2520,2438.899414,17607900,70,0,2487.142857,2500.714286,2607.142857,74.09774754,2490
EXCL.JK,2020-08-24,2530,2560,2480,2490,2409.864746,13155200,80,-40,2498.571429,2485.714286,2591.428571,71.74690967,2480
EXCL.JK,2020-08-25,2540,2540,2480,2480,2400.186768,9946700,60,-60,2504.285714,2482.142857,2573.333333,68.76460884,2540
EXCL.JK,2020-08-26,2500,2540,2480,2540,2458.255859,14089700,60,40,2514.285714,2480.714286,2556.190476,56.82051943,2540
EXCL.JK,2020-08-27,2560,2580,2510,2540,2458.255859,21293200,70,-20,2530,2492.142857,2543.809524,43.20493799,2550
EXCL.JK,2020-08-28,2570,2590,2540,2550,2467.933838,17994200,50,-20,2520,2499.285714,2530.47619,26.45751311,2440
EXCL.JK,2020-08-31,2550,2580,2410,2440,2361.473877,30595700,170,-110,2520,2504.285714,2520.47619,26.45751311,2420
EXCL.JK,2020-09-01,2490,2490,2390,2420,2342.117676,20611800,100,-70,2508.571429,2497.857143,2503.333333,40.1781746,2410
EXCL.JK,2020-09-02,2420,2450,2410,2410,2332.439453,15335700,40,-10,2494.285714,2496.428571,2488.571429,51.5936504,2340
EXCL.JK,2020-09-03,2430,2450,2330,2340,2264.692383,33632500,120,-90,2482.857143,2493.571429,2482.380952,60.74928963,2300
EXCL.JK,2020-09-04,2340,2340,2270,2300,2225.979736,23127600,70,-40,2462.857143,2488.571429,2474.761905,81.38678961,2250
EXCL.JK,2020-09-07,2330,2340,2240,2250,2177.588867,25311600,100,-80,2428.571429,2479.285714,2470.952381,93.17162863,2240
EXCL.JK,2020-09-08,2260,2280,2230,2240,2167.9104,16285100,50,-20,2387.142857,2453.571429,2461.904762,99.61831922,2190
EXCL.JK,2020-09-09,2220,2220,2150,2190,2119.519775,22900900,70,-30,2342.857143,2431.428571,2450.47619,82.60635281,2040
EXCL.JK,2020-09-10,2180,2180,2040,2040,1974.347168,27586900,140,-140,2307.142857,2407.857143,2434.285714,87.50510189,2190
EXCL.JK,2020-09-11,1970,2220,1920,2190,2119.519775,38634100,300,220,2252.857143,2373.571429,2415.238095,118.2813434,2270
EXCL.JK,2020-09-14,2230,2290,2200,2270,2196.945068,22762500,90,40,2221.428571,2352.142857,2402.857143,96.85531674,2200
EXCL.JK,2020-09-15,2270,2280,2180,2200,2129.197998,17481300,100,-70,2211.428571,2337.142857,2396.190476,85.52359741,2130
EXCL.JK,2020-09-16,2200,2210,2120,2130,2061.450684,12124900,90,-70,2197.142857,2312.857143,2385.238095,76.0951785,2090
EXCL.JK,2020-09-17,2130,2160,2080,2090,2022.737915,11929300,80,-40,2180,2283.571429,2362.380952,75.71877794,2150
EXCL.JK,2020-09-18,2090,2180,2090,2150,2080.806885,14899900,90,60,2158.571429,2250.714286,2340.47619,77.12080814,2060
EXCL.JK,2020-09-21,2150,2160,2040,2060,1993.703491,9385900,120,-90,2152.857143,2230,2322.857143,75.87583843,2030
EXCL.JK,2020-09-22,2040,2070,2000,2030,1964.668945,8424800,70,-10,2155.714286,2204.285714,2300.952381,71.14706432,1985
EXCL.JK,2020-09-23,2040,2080,1955,1985,1921.117188,22773800,125,-55,2132.857143,2177.142857,2279.047619,83.00889224,1930
EXCL.JK,2020-09-24,1950,1990,1920,1930,1867.887207,14736500,70,-20,2092.142857,2151.785714,2255.47619,73.92885898,1965
EXCL.JK,2020-09-25,1950,1990,1930,1965,1901.760864,18214300,60,15,2053.571429,2125.357143,2226.428571,78.56601713,2010
EXCL.JK,2020-09-28,1985,2030,1940,2010,1945.312622,20240900,90,25,2030,2105,2199.047619,76.53975002,1990
EXCL.JK,2020-09-29,2030,2040,1980,1990,1925.956299,11958900,60,-40,2018.571429,2088.571429,2173.333333,71.92092218,2030
EXCL.JK,2020-09-30,2010,2040,1975,2030,1964.668945,13929900,65,20,1995.714286,2074.285714,2151.904762,42.66424844,2200
EXCL.JK,2020-10-01,2050,2220,2040,2200,2129.197998,31801300,180,150,1991.428571,2073.571429,2133.333333,36.13796315,2100
EXCL.JK,2020-10-02,2200,2200,2070,2100,2032.41626,22525200,130,-100,2015.714286,2074.285714,2123.333333,87.29397514,2090
EXCL.JK,2020-10-05,2140,2140,2080,2090,2022.737915,7714500,60,-50,2032.142857,2062.142857,2111.904762,91.28057218,2120
EXCL.JK,2020-10-06,2130,2150,2110,2120,2051.772461,8640800,40,-10,2055,2054.285714,2101.904762,80.88057039,2180
EXCL.JK,2020-10-07,2100,2180,2090,2180,2109.841553,16304900,90,80,2077.142857,2053.571429,2095.714286,72.96444013,2200
EXCL.JK,2020-10-08,2200,2230,2160,2200,2129.197998,23602800,70,0,2101.428571,2060,2092.857143,75.15064236,2200
EXCL.JK,2020-10-09,2220,2240,2190,2200,2129.197998,17913200,50,-20,2131.428571,2063.571429,2093.333333,64.40201121,2210
EXCL.JK,2020-10-12,2230,2240,2190,2210,2138.875977,14458100,50,-20,2155.714286,2073.571429,2100.952381,50.28490259,2190
EXCL.JK,2020-10-13,2190,2200,2130,2190,2119.519775,10805900,70,0,2157.142857,2086.428571,2101.904762,51.86980037,2210
EXCL.JK,2020-10-14,2190,2230,2180,2210,2138.875977,21953100,50,20,2170,2101.071429,2098.095238,46.18802154,2130
EXCL.JK,2020-10-15,2210,2210,2130,2130,2061.450684,18152600,80,-80,2187.142857,2121.071429,2098.571429,31.4718317,2130
EXCL.JK,2020-10-16,2130,2160,2110,2130,2061.450684,8366500,50,0,2188.571429,2132.857143,2098.571429,27.94552524,2130
EXCL.JK,2020-10-19,2160,2180,2100,2130,2061.450684,10254500,80,-30,2181.428571,2141.428571,2100.47619,35.79039509,2090
EXCL.JK,2020-10-20,2130,2150,2080,2090,2022.737915,12525000,70,-40,2171.428571,2151.428571,2099.52381,39.33978962,2050
EXCL.JK,2020-10-21,2110,2130,2040,2050,1984.025391,11580300,90,-60,2155.714286,2155.714286,2100.952381,47.20774755,2110
EXCL.JK,2020-10-22,2050,2110,2040,2110,2042.09436,15297300,70,60,2132.857143,2145,2101.904762,54.68524655,2070
EXCL.JK,2020-10-23,2130,2140,2060,2070,2003.381714,13956000,80,-60,2121.428571,2145.714286,2107.857143,48.79500365,2040
EXCL.JK,2020-10-26,2070,2100,2030,2040,1974.347168,13638200,70,-30,2101.428571,2144.285714,2114.52381,32.36694375,2030
EXCL.JK,2020-10-27,2000,2060,2000,2030,1964.668945,16338100,60,30,2088.571429,2138.571429,2118.095238,36.70993119,2010
EXCL.JK,2020-11-02,2020,2040,2000,2010,1945.312622,21849400,40,-10,2074.285714,2127.857143,2119.047619,37.35288604,2010
EXCL.JK,2020-11-03,2040,2050,2010,2010,1945.312622,24213900,40,-30,2057.142857,2114.285714,2120,34.98298906,1985
EXCL.JK,2020-11-04,2010,2040,1980,1985,1921.117188,27511600,60,-25,2045.714286,2100.714286,2119.047619,35.52329886,2110
EXCL.JK,2020-11-05,2020,2160,2000,2110,2042.09436,95943600,160,90,2036.428571,2084.642857,2108.809524,42.10248268,2180
EXCL.JK,2020-11-06,2150,2200,2120,2180,2109.841553,71675400,80,30,2036.428571,2078.928571,2109.285714,42.10248268,2130
EXCL.JK,2020-11-09,2200,2230,2130,2130,2061.450684,72118100,100,-70,2052.142857,2076.785714,2113.571429,68.79057244,2190
EXCL.JK,2020-11-10,2170,2210,2150,2190,2119.519775,62591600,60,20,2065,2076.785714,2114.047619,74.33034374,2340
EXCL.JK,2020-11-11,2140,2360,2120,2340,2264.692383,138426900,240,200,2087.857143,2081.071429,2114.52381,85.53055706,2290
EXCL.JK,2020-11-12,2350,2370,2270,2290,2216.301514,35445500,100,-60,2135,2096.071429,2121.190476,119.6174458,2290
EXCL.JK,2020-11-13,2280,2320,2250,2290,2216.301514,22623400,70,10,2175,2110.357143,2125.47619,117.6506127,2320
EXCL.JK,2020-11-16,2320,2350,2300,2320,2245.335938,22309600,50,0,2218.571429,2127.5,2129.285714,88.3984486,2300
EXCL.JK,2020-11-17,2350,2370,2290,2300,2225.979736,47270300,80,-50,2248.571429,2142.5,2135.47619,80.7111251,2300
EXCL.JK,2020-11-18,2300,2330,2290,2300,2225.979736,20395100,40,0,2265.714286,2158.928571,2139.761905,76.34508123,2300
EXCL.JK,2020-11-19,2300,2320,2280,2300,2225.979736,18962300,40,0,2290,2177.5,2147.857143,47.60952286,2300
EXCL.JK,2020-11-20,2310,2350,2290,2300,2225.979736,32517100,60,-10,2305.714286,2196.785714,2155.952381,18.12653934,2430
EXCL.JK,2020-11-23,2330,2450,2320,2430,2351.795898,86246300,130,100,2300,2217.5,2164.047619,10,2500
EXCL.JK,2020-11-24,2600,2600,2460,2500,2419.543213,78027200,140,-100,2320,2247.5,2180.238095,49.32882862,2490
EXCL.JK,2020-11-25,2530,2540,2440,2490,2409.864746,56208700,100,-40,2350,2284.285714,2201.666667,81.44527815,2540
EXCL.JK,2020-11-26,2470,2570,2470,2540,2458.255859,41247500,100,70,2374.285714,2311.428571,2219.761905,95.19403743,2530
EXCL.JK,2020-11-27,2560,2560,2510,2530,2448.577637,44053700,50,-30,2408.571429,2337.142857,2242.142857,106.5252038,2410
EXCL.JK,2020-11-30,2510,2520,2380,2410,2332.439453,358988600,140,-100,2441.428571,2365.714286,2265.47619,102.8637564,2450
EXCL.JK,2020-12-01,2470,2550,2420,2450,2371.152344,87903400,130,-20,2457.142857,2381.428571,2283.571429,84.40266301,2460
EXCL.JK,2020-12-02,2460,2500,2410,2460,2380.830322,110992200,90,0,2478.571429,2389.285714,2304.52381,49.80915961,2420
EXCL.JK,2020-12-03,2470,2470,2410,2420,2342.117676,66043400,60,-50,2482.857143,2401.428571,2325.952381,46.08480795,2450
EXCL.JK,2020-12-04,2420,2480,2380,2450,2371.152344,83546400,100,30,2471.428571,2410.714286,2346.666667,50.80307452,2520
EXCL.JK,2020-12-07,2450,2540,2450,2520,2438.899414,65723500,90,70,2465.714286,2420,2362.857143,50.61526214,2480
EXCL.JK,2020-12-08,2540,2560,2470,2480,2400.186768,47643100,90,-60,2462.857143,2435.714286,2379.047619,46.08480795,2420
EXCL.JK,2020-12-10,2480,2500,2400,2420,2342.117676,42946600,100,-60,2455.714286,2448.571429,2395.714286,36.90399385,2460
EXCL.JK,2020-12-11,2430,2500,2430,2460,2380.830322,34539400,70,30,2457.142857,2457.142857,2406.666667,34.98298906,2620
EXCL.JK,2020-12-14,2480,2670,2450,2620,2535.681152,245113700,220,140,2458.571429,2468.571429,2412.380952,34.84660262,2700
EXCL.JK,2020-12-15,2650,2730,2570,2700,2613.106689,173537800,160,50,2481.428571,2482.142857,2428.095238,70.33931367,2900
EXCL.JK,2020-12-16,2740,2960,2710,2900,2806.670166,252281100,250,160,2521.428571,2496.428571,2447.619048,102.0504077,2790
EXCL.JK,2020-12-17,2900,2940,2730,2790,2700.210205,101866300,210,-110,2585.714286,2525.714286,2475.238095,169.1997974,2790
EXCL.JK,2020-12-18,2790,2830,2710,2790,2700.210205,88493100,120,0,2624.285714,2543.571429,2498.571429,182.0125584,2900
EXCL.JK,2020-12-21,2790,2950,2780,2900,2806.670166,128295300,170,110,2668.571429,2562.142857,2521.904762,178.738969,2760
EXCL.JK,2020-12-22,2950,2980,2740,2760,2671.175537,97458400,240,-190,2737.142857,2597.142857,2550.47619,158.3997354,2710
EXCL.JK,2020-12-23,2780,2820,2600,2710,2622.784668,61822500,220,-70,2780,2619.285714,2572.380952,101.1599394,2810
EXCL.JK,2020-12-28,2740,2820,2670,2810,2719.566406,58886400,150,70,2792.857143,2637.142857,2585.714286,81.18174789,2850
EXCL.JK,2020-12-29,2870,2920,2810,2850,2758.279053,81822400,110,-20,2808.571429,2665,2600.47619,70.10196655,2730
EXCL.JK,2020-12-30,2850,2860,2730,2730,2642.141113,48118500,130,-120,2801.428571,2693.571429,2617.619048,61.21780009,2840
EXCL.JK,2021-01-04,2790,2840,2660,2840,2748.60083,35547100,180,50,2792.857143,2708.571429,2626.666667,67.01101544,2810
EXCL.JK,2021-01-05,2830,2850,2770,2810,2719.566406,24647900,80,-20,2800,2734.285714,2641.428571,69.2820323,2740
EXCL.JK,2021-01-06,2830,2850,2700,2740,2651.819336,37062700,150,-90,2787.142857,2762.142857,2660.47619,54.37961803,2730
EXCL.JK,2021-01-07,2760,2810,2720,2730,2642.141113,44467300,90,-30,2784.285714,2782.142857,2674.285714,56.52643714,2810
EXCL.JK,2021-01-08,2760,2880,2740,2810,2719.566406,64480200,140,50,2787.142857,2790,2687.142857,52.50850271,2790
EXCL.JK,2021-01-11,2840,2870,2780,2790,2700.210205,41151700,90,-50,2787.142857,2797.857143,2705.714286,52.50850271,2760
EXCL.JK,2021-01-12,2800,2820,2750,2760,2671.175537,38200300,70,-40,2778.571429,2790,2721.904762,44.88079449,2750
EXCL.JK,2021-01-13,2790,2810,2700,2750,2661.497314,33432500,110,-40,2782.857143,2787.857143,2733.333333,40.70801957,2700
EXCL.JK,2021-01-14,2760,2780,2700,2700,2613.106689,30861900,80,-60,2770,2785,2746.190476,33.1662479,2600
EXCL.JK,2021-01-15,2710,2740,2600,2600,2516.324707,57119200,140,-110,2754.285714,2770.714286,2759.52381,36.90399385,2480
EXCL.JK,2021-01-18,2600,2600,2480,2480,2400.186768,74290200,120,-120,2734.285714,2759.285714,2766.190476,69.4879229,2630
EXCL.JK,2021-01-19,2500,2660,2420,2630,2545.359375,89602800,240,130,2698.571429,2742.857143,2759.52381,118.8035594,2570
EXCL.JK,2021-01-20,2650,2660,2530,2570,2487.290283,36460700,130,-80,2672.857143,2730,2756.190476,109.805022,2550
EXCL.JK,2021-01-21,2600,2620,2520,2550,2467.933838,25922500,100,-50,2641.428571,2710,2740.47619,101.8869588,2430
EXCL.JK,2021-01-22,2550,2560,2420,2430,2351.795898,43953400,140,-120,2611.428571,2697.142857,2729.047619,91.54754164,2400
EXCL.JK,2021-01-25,2400,2490,2340,2400,2322.76123,42651600,150,0,2565.714286,2667.857143,2711.904762,90.71147352,2290
EXCL.JK,2021-01-26,2400,2440,2270,2290,2216.301514,49666000,170,-110,2522.857143,2638.571429,2688.095238,87.50510189,2350
EXCL.JK,2021-01-27,2300,2370,2260,2350,2274.370361,44536800,110,50,2478.571429,2606.428571,2665.714286,115.8200575,2270
EXCL.JK,2021-01-28,2300,2360,2220,2270,2196.945068,37148300,140,-30,2460,2579.285714,2648.571429,125.565388,2220
EXCL.JK,2021-01-29,2310,2360,2200,2220,2148.554199,40832800,160,-90,2408.571429,2540.714286,2622.857143,117.8174536,2310
EXCL.JK,2021-02-01,2220,2320,2170,2310,2235.657715,32512600,150,90,2358.571429,2500,2592.857143,112.0161553,2270
EXCL.JK,2021-02-02,2330,2360,2240,2270,2196.945068,21978200,120,-60,2324.285714,2467.857143,2572.857143,73.90470054,2340
EXCL.JK,2021-02-03,2310,2380,2260,2340,2264.692383,26217900,120,30,2301.428571,2433.571429,2545.714286,58.99959645,2410
EXCL.JK,2021-02-04,2340,2450,2330,2410,2332.439453,57229100,120,70,2292.857143,2407.857143,2523.333333,44.98677054,2370
EXCL.JK,2021-02-05,2420,2440,2360,2370,2293.726807,29994800,80,-50,2310,2394.285714,2507.619048,62.98147876,2340
EXCL.JK,2021-02-08,2400,2420,2330,2340,2264.692383,27172800,90,-60,2312.857143,2386.428571,2490.47619,65.50172662,2330
EXCL.JK,2021-02-09,2380,2400,2310,2330,2255.01416,30931900,90,-50,2322.857143,2365.714286,2468.095238,63.17021601,2340
EXCL.JK,2021-02-10,2320,2400,2300,2340,2264.692383,24148800,100,20,2338.571429,2348.571429,2446.190476,44.13183712,2340
EXCL.JK,2021-02-11,2350,2380,2320,2340,2264.692383,6941700,60,-10,2342.857143,2333.571429,2426.190476,42.31401884,2300
EXCL.JK,2021-02-15,2370,2370,2290,2300,2225.979736,24967300,80,-70,2352.857143,2327.142857,2406.666667,28.11540842,2210
EXCL.JK,2021-02-16,2300,2330,2180,2210,2138.875977,113296400,150,-90,2347.142857,2320,2387.619048,34.50327797,2160
EXCL.JK,2021-02-17,2230,2240,2150,2160,2090.485352,54910900,90,-70,2318.571429,2314.285714,2369.047619,52.09880723,2180
EXCL.JK,2021-02-18,2170,2220,2160,2180,2109.841553,32259100,60,10,2288.571429,2300.714286,2353.809524,73.58183006,2140
EXCL.JK,2021-02-19,2180,2190,2120,2140,2071.128906,39768500,70,-40,2265.714286,2294.285714,2332.380952,79.55231881,2130
EXCL.JK,2021-02-22,2150,2170,2120,2130,2061.450684,30665800,50,-20,2238.571429,2288.571429,2311.904762,86.10624666,2220
EXCL.JK,2021-02-23,2140,2240,2130,2220,2148.554199,63740500,110,80,2208.571429,2275.714286,2291.904762,81.32825901,2160
EXCL.JK,2021-02-24,2240,2250,2150,2160,2090.485352,50930400,100,-80,2191.428571,2272.142857,2281.904762,58.43188953,2220
EXCL.JK,2021-02-25,2190,2230,2170,2220,2148.554199,38663200,60,30,2171.428571,2259.285714,2270.47619,33.8765265,2200
EXCL.JK,2021-02-26,2170,2210,2160,2200,2129.197998,35677300,50,30,2172.857143,2245.714286,2267.142857,35.9231985,2220
EXCL.JK,2021-03-01,2200,2240,2190,2220,2148.554199,20313400,50,20,2178.571429,2233.571429,2260,36.70993119,2250
EXCL.JK,2021-03-02,2230,2270,2230,2250,2177.588867,34594800,40,20,2184.285714,2225,2257.619048,39.94043184,2240
EXCL.JK,2021-03-03,2260,2270,2230,2240,2167.9104,14698600,40,-20,2200,2219.285714,2259.047619,41.23105626,2220
EXCL.JK,2021-03-04,2220,2230,2180,2220,2148.554199,19508600,50,0,2215.714286,2212.142857,2255.714286,29.35821456,2190
EXCL.JK,2021-03-05,2200,2220,2180,2190,2119.519775,20833400,40,-10,2215.714286,2203.571429,2253.333333,29.35821456,2180
EXCL.JK,2021-03-08,2210,2220,2160,2180,2109.841553,20290100,60,-30,2220,2195.714286,2246.190476,20.81665999,2130
EXCL.JK,2021-03-09,2200,2200,2130,2130,2061.450684,20511500,70,-70,2214.285714,2193.571429,2235.238095,25.72750983,2120
EXCL.JK,2021-03-10,2150,2170,2120,2120,2051.772461,13536300,50,-30,2204.285714,2191.428571,2223.809524,41.17326918,2150
EXCL.JK,2021-03-12,2140,2170,2130,2150,2080.806885,15503900,40,10,2190,2187.142857,2213.333333,50.99019514,2150
EXCL.JK,2021-03-15,2160,2170,2130,2150,2080.806885,11779100,40,-10,2175.714286,2187.857143,2204.761905,45.03966506,2220
EXCL.JK,2021-03-16,2150,2320,2140,2220,2148.554199,91487900,180,70,2162.857143,2189.285714,2195.714286,35.45621042,2210
EXCL.JK,2021-03-17,2220,2250,2180,2210,2138.875977,16411000,70,-10,2162.857143,2189.285714,2190,35.45621042,2210
EXCL.JK,2021-03-18,2210,2250,2200,2210,2138.875977,24453800,50,0,2165.714286,2192.857143,2185.714286,38.66830867,2210
EXCL.JK,2021-03-19,2200,2230,2190,2210,2138.875977,18277000,40,10,2170,2192.142857,2185.714286,42.03173404,2160
EXCL.JK,2021-03-22,2220,2230,2150,2160,2090.485352,23015000,80,-60,2181.428571,2192.857143,2188.095238,40.1781746,2150
EXCL.JK,2021-03-23,2160,2180,2150,2150,2080.806885,8768900,30,-10,2187.142857,2188.571429,2187.142857,31.99702367,2080
EXCL.JK,2021-03-24,2140,2170,2050,2080,2013.059814,37687100,120,-60,2187.142857,2181.428571,2187.619048,31.99702367,2090
EXCL.JK,2021-03-25,2080,2100,2010,2090,2022.737915,25301000,90,10,2177.142857,2170,2185.238095,50.89672082,2100
EXCL.JK,2021-03-26,2110,2120,2070,2100,2032.41626,13398300,50,-10,2158.571429,2160.714286,2179.047619,56.10364558,2090
EXCL.JK,2021-03-29,2110,2120,2080,2090,2022.737915,12245400,40,-20,2142.857143,2154.285714,2176.190476,54.68524655,2050
EXCL.JK,2021-03-30,2100,2110,2040,2050,1984.025391,18449300,70,-50,2125.714286,2147.857143,2170,48.5994317,2090
EXCL.JK,2021-03-31,2070,2090,2040,2090,2022.737915,14612300,50,20,2102.857143,2142.142857,2162.857143,39.03600292,2090
EXCL.JK,2021-04-01,2090,2110,2060,2090,2022.737915,9835300,50,0,2092.857143,2140,2156.666667,29.84084768,2070
EXCL.JK,2021-04-05,2110,2120,2070,2070,2003.381714,7686500,50,-40,2084.285714,2135.714286,2149.047619,16.18347187,2160
EXCL.JK,2021-04-06,2080,2170,2070,2160,2090.485352,20579200,100,80,2082.857143,2130,2140.952381,17.04336206,2200
EXCL.JK,2021-04-07,2170,2200,2130,2200,2129.197998,20134200,70,30,2092.857143,2125.714286,2138.095238,34.01680257,2160
EXCL.JK,2021-04-08,2200,2240,2160,2160,2090.485352,18247200,80,-40,2107.142857,2125,2138.571429,53.13952883,2160
EXCL.JK,2021-04-09,2190,2200,2140,2160,2090.485352,18518700,60,-30,2117.142857,2121.428571,2137.619048,55.89105048,2070
EXCL.JK,2021-04-12,2160,2170,2050,2070,2003.381714,16509400,120,-90,2132.857143,2117.857143,2139.047619,48.89249626,2040
EXCL.JK,2021-04-13,2070,2090,2030,2040,1974.347168,18775300,60,-30,2130,2111.428571,2136.666667,52.28129047,2070
EXCL.JK,2021-04-14,2060,2080,2040,2070,2003.381714,12979800,40,10,2122.857143,2103.571429,2131.428571,61.29553701,2050
EXCL.JK,2021-04-15,2070,2070,2030,2050,1984.025391,22275200,40,-20,2122.857143,2102.857143,2127.619048,61.29553701,2010
EXCL.JK,2021-04-16,2080,2080,2010,2010,1945.312622,47488800,70,-70,2107.142857,2100,2119.52381,64.21689438,2030
EXCL.JK,2021-04-19,2040,2080,2020,2030,1964.668945,27001500,60,-10,2080,2093.571429,2110,58.30951895,2030
EXCL.JK,2021-04-20,2030,2050,2010,2030,1964.668945,19262600,40,0,2061.428571,2089.285714,2101.428571,48.4522347,2020
EXCL.JK,2021-04-21,2020,2040,2010,2020,1954.990723,11897000,30,0,2042.857143,2087.857143,2092.857143,22.14669706,2060
EXCL.JK,2021-04-22,2020,2060,2020,2060,1993.703491,14378700,40,40,2035.714286,2082.857143,2086.190476,19.88059595,2040
EXCL.JK,2021-04-23,2040,2060,2020,2040,1974.347168,11515600,40,0,2038.571429,2080.714286,2081.904762,21.93062655,2030
EXCL.JK,2021-04-26,2060,2070,2020,2030,1964.668945,11699600,50,-30,2034.285714,2078.571429,2080,17.18249386,2020
EXCL.JK,2021-04-27,2060,2060,2020,2020,1954.990723,11219900,40,-40,2031.428571,2069.285714,2077.142857,15.73591585,2050
EXCL.JK,2021-04-28,2020,2060,2020,2050,1984.025391,17312000,40,30,2032.857143,2056.428571,2073.333333,13.80131119,2090
EXCL.JK,2021-04-29,2050,2120,2050,2090,2022.737915,26099500,70,40,2035.714286,2048.571429,2071.428571,15.11857892,2090
EXCL.JK,2021-04-30,2100,2110,2070,2090,2022.737915,33397400,40,-10,2044.285714,2043.571429,2073.333333,25.07132682,2060
EXCL.JK,2021-05-03,2080,2090,2060,2060,1993.703491,8858000,30,-20,2054.285714,2045,2073.333333,27.60262237,2030
EXCL.JK,2021-05-04,2050,2050,2020,2030,1995.374512,10799500,30,-20,2054.285714,2046.428571,2071.904762,27.60262237,2060
EXCL.JK,2021-05-05,2030,2070,2020,2060,2024.862793,10294200,50,30,2052.857143,2043.571429,2070,28.70208222,2030
EXCL.JK,2021-05-06,2060,2070,2030,2030,1995.374512,5918700,40,-30,2057.142857,2044.285714,2065.238095,26.90370837,2030
EXCL.JK,2021-05-07,2030,2040,2020,2030,1995.374512,9839900,20,0,2058.571429,2045.714286,2057.142857,24.78478796,2030
EXCL.JK,2021-05-10,2030,2050,2030,2030,1995.374512,5405300,20,0,2055.714286,2045.714286,2050.952381,26.99206233,2020
EXCL.JK,2021-05-11,2030,2030,2010,2020,1985.545044,10231300,20,-10,2047.142857,2045.714286,2044.761905,23.60387377,1980
EXCL.JK,2021-05-17,2020,2050,1980,1980,1946.227417,20517300,70,-40,2037.142857,2045.714286,2042.380952,16.03567451,2060
EXCL.JK,2021-05-18,1985,2060,1985,2060,2024.862793,18465100,75,75,2025.714286,2040,2039.52381,23.70453041,2060
EXCL.JK,2021-05-19,2050,2090,2010,2060,2024.862793,28031700,80,10,2030,2041.428571,2039.047619,27.08012802,2220
EXCL.JK,2021-05-20,2060,2230,2050,2220,2182.133789,134303900,180,160,2030,2043.571429,2039.52381,27.08012802,2240
EXCL.JK,2021-05-21,2220,2270,2160,2240,2201.79248,70443200,110,20,2057.142857,2057.857143,2049.52381,76.74943772,2230
EXCL.JK,2021-05-24,2240,2250,2180,2230,2191.963135,29168300,70,-10,2087.142857,2071.428571,2059.52381,101.4419844,2290
EXCL.JK,2021-05-25,2230,2320,2210,2290,2250.939697,68743200,110,60,2115.714286,2081.428571,2069.047619,110.4320519,2390
EXCL.JK,2021-05-27,2300,2410,2280,2390,2349.234131,68682000,130,90,2154.285714,2095.714286,2081.904762,118.3014712,2360
EXCL.JK,2021-05-28,2390,2410,2310,2360,2319.74585,32188200,100,-30,2212.857143,2119.285714,2097.619048,119.1237852,2460
EXCL.JK,2021-05-31,2380,2550,2380,2460,2418.040039,101613500,170,80,2255.714286,2142.857143,2112.857143,108.4523156,2580
EXCL.JK,2021-06-02,2480,2590,2450,2580,2535.993164,63670500,140,100,2312.857143,2171.428571,2133.333333,92.32447955,2560
EXCL.JK,2021-06-03,2580,2630,2490,2560,2516.334473,56949100,140,-20,2364.285714,2210.714286,2160,126.0763185,2550
EXCL.JK,2021-06-04,2560,2590,2480,2550,2506.504883,28430900,110,-10,2410,2248.571429,2184.285714,131.402689,2590
EXCL.JK,2021-06-07,2550,2620,2530,2590,2545.822754,39327600,90,40,2455.714286,2285.714286,2206.190476,112.6731472,2430
EXCL.JK,2021-06-08,2540,2560,2410,2430,2388.551758,82070400,150,-110,2498.571429,2326.428571,2230,94.76788687,2470
EXCL.JK,2021-06-09,2400,2500,2370,2470,2427.869385,34257300,130,70,2504.285714,2358.571429,2247.619048,88.10167287,2570
EXCL.JK,2021-06-10,2490,2600,2430,2570,2526.163818,61336900,170,80,2520,2387.857143,2268.571429,64.80740698,2570
EXCL.JK,2021-06-11,2600,2610,2550,2570,2526.163818,30540200,60,-30,2535.714286,2424.285714,2292.857143,61.06202935,2480
EXCL.JK,2021-06-14,2550,2550,2460,2480,2437.698975,22979600,90,-70,2534.285714,2449.285714,2318.571429,59.96030433,2500
EXCL.JK,2021-06-15,2460,2540,2450,2500,2457.35791,26247200,90,40,2522.857143,2466.428571,2340,61.83695921,2660
EXCL.JK,2021-06-16,2540,2680,2500,2660,2614.628662,98526200,180,120,2515.714286,2485.714286,2362.380952,61.06202935,2590
EXCL.JK,2021-06-17,2650,2680,2540,2590,2545.822754,58230800,140,-60,2525.714286,2512.142857,2392.857143,78.497801,2580
EXCL.JK,2021-06-18,2590,2630,2470,2580,2535.993164,37770000,160,-10,2548.571429,2526.428571,2421.904762,68.66065623,2700
EXCL.JK,2021-06-21,2540,2740,2480,2700,2653.946533,80185500,260,160,2564.285714,2542.142857,2446.666667,59.68169537,2780
EXCL.JK,2021-06-22,2720,2800,2710,2780,2732.581787,68415700,90,60,2582.857143,2559.285714,2477.142857,78.89112449,2750
EXCL.JK,2021-06-23,2780,2790,2710,2750,2703.093506,37422900,80,-30,2612.857143,2573.571429,2503.809524,107.8137724,2730
EXCL.JK,2021-06-24,2780,2780,2710,2730,2683.434814,16817100,70,-50,2651.428571,2587.142857,2528.095238,100.403946,2730
EXCL.JK,2021-06-25,2750,2750,2710,2730,2683.434814,14812100,40,-20,2684.285714,2600,2551.904762,77.64387567,2630
EXCL.JK,2021-06-28,2740,2780,2620,2630,2585.140381,24892100,160,-110,2694.285714,2610,2572.857143,78.497801,2630
EXCL.JK,2021-06-29,2630,2700,2610,2630,2585.140381,25759600,90,0,2700,2624.285714,2584.285714,70.71067812,2670
EXCL.JK,2021-06-30,2630,2730,2610,2670,2624.458008,21387400,120,40,2707.142857,2635.714286,2597.142857,57.94085654,2640
EXCL.JK,2021-07-01,2670,2700,2600,2640,2594.969727,35634200,100,-30,2702.857143,2642.857143,2607.142857,59.64178784,2630
EXCL.JK,2021-07-02,2650,2670,2630,2630,2585.140381,10735800,40,-20,2682.857143,2647.857143,2610,52.50850271,2550
EXCL.JK,2021-07-05,2630,2660,2520,2550,2506.504883,43171800,140,-80,2665.714286,2658.571429,2613.333333,46.13644361,2590
EXCL.JK,2021-07-06,2600,2660,2560,2590,2545.822754,36414100,100,-10,2640,2662.142857,2613.333333,53.85164807,2600
EXCL.JK,2021-07-07,2590,2630,2590,2600,2555.6521,11669900,40,10,2620,2657.142857,2613.333333,38.72983346,2560
EXCL.JK,2021-07-08,2610,2640,2520,2560,2516.334473,28020700,120,-50,2615.714286,2657.857143,2621.428571,39.0969491,2600
EXCL.JK,2021-07-09,2550,2610,2540,2600,2555.6521,16354900,70,50,2605.714286,2656.428571,2625.714286,43.53433237,2610
EXCL.JK,2021-07-12,2630,2720,2590,2610,2565.481445,34004200,130,-20,2595.714286,2649.285714,2627.142857,33.09438163,2440
EXCL.JK,2021-07-13,2650,2670,2430,2440,2398.381104,49178300,240,-210,2591.428571,2637.142857,2629.047619,27.94552524,2490
EXCL.JK,2021-07-14,2420,2500,2360,2490,2447.52832,41389000,140,70,2564.285714,2615,2627.142857,59.12053869,2480
EXCL.JK,2021-07-15,2500,2530,2460,2480,2437.698975,17350000,70,-20,2555.714286,2597.857143,2626.666667,65.538066,2490
EXCL.JK,2021-07-16,2470,2520,2460,2490,2447.52832,11208600,60,20,2540,2580,2618.095238,69.04105059,2470
EXCL.JK,2021-07-19,2480,2480,2430,2470,2427.869385,16181200,50,-10,2524.285714,2570,2613.333333,65.538066,2470
EXCL.JK,2021-07-21,2470,2510,2450,2470,2427.869385,21375100,60,0,2511.428571,2558.571429,2608.095238,66.18876325,2510
EXCL.JK,2021-07-22,2500,2540,2490,2510,2467.187256,20560000,50,10,2492.857143,2544.285714,2597.142857,54.37961803,2450
EXCL.JK,2021-07-23,2510,2530,2440,2450,2408.210693,23954700,90,-60,2478.571429,2535,2584.285714,21.93062655,2410
EXCL.JK,2021-07-26,2450,2470,2410,2410,2368.892822,23519000,60,-40,2480,2522.142857,2570,19.14854216,2430
EXCL.JK,2021-07-27,2410,2470,2410,2430,2388.551758,10169500,60,20,2468.571429,2512.142857,2554.761905,31.84785259,2400
EXCL.JK,2021-07-28,2440,2460,2380,2400,2359.063477,20385100,80,-40,2461.428571,2500.714286,2540.47619,34.36498772,2540
EXCL.JK,2021-07-29,2420,2550,2420,2540,2496.675537,36647700,130,120,2448.571429,2486.428571,2529.52381,38.48314411,2690
EXCL.JK,2021-07-30,2570,2700,2570,2690,2644.116943,67138900,130,120,2458.571429,2485,2525.238095,51.77791403,2650
EXCL.JK,2021-08-02,2700,2730,2620,2650,2604.799316,32009200,110,-50,2490,2491.428571,2526.190476,102.1436896,2660
EXCL.JK,2021-08-03,2680,2690,2640,2660,2614.628662,18290200,50,-20,2510,2494.285714,2526.666667,119.0238071,2670
EXCL.JK,2021-08-04,2670,2690,2620,2670,2624.458008,14578300,70,0,2540,2510,2528.095238,127.5408431,2610
EXCL.JK,2021-08-05,2680,2680,2550,2610,2565.481445,30263300,130,-70,2577.142857,2522.857143,2533.809524,121.0666876,2590
EXCL.JK,2021-08-06,2610,2650,2580,2590,2545.822754,13753100,70,-20,2602.857143,2532.142857,2534.761905,102.2601724,2560
EXCL.JK,2021-08-09,2600,2650,2520,2560,2516.334473,22512400,130,-40,2630,2539.285714,2534.285714,52.59911279,2540
EXCL.JK,2021-08-10,2500,2600,2500,2540,2496.675537,21559000,100,40,2632.857143,2545.714286,2534.285714,47.15728495,2610
EXCL.JK,2021-08-12,2570,2640,2560,2610,2565.481445,19451900,80,40,2611.428571,2550.714286,2531.428571,50.80307452,2570
EXCL.JK,2021-08-13,2640,2660,2550,2570,2526.163818,12413900,110,-70,2605.714286,2557.857143,2531.428571,47.90864322,2590
EXCL.JK,2021-08-16,2570,2630,2500,2590,2545.822754,27167400,130,20,2592.857143,2566.428571,2537.619048,42.70608298,2680
EXCL.JK,2021-08-18,2560,2680,2520,2680,2634.287598,40629100,160,120,2581.428571,2579.285714,2542.380952,26.0950643,2600
EXCL.JK,2021-08-19,2650,2650,2550,2600,2555.6521,28576300,100,-50,2591.428571,2597.142857,2551.904762,45.25062483,2700
EXCL.JK,2021-08-20,2600,2720,2570,2700,2653.946533,34938900,150,100,2592.857143,2611.428571,2557.142857,45.35573676,2730
EXCL.JK,2021-08-23,2720,2770,2720,2730,2683.434814,23561300,50,10,2612.857143,2622.857143,2568.095238,57.65248931,2640
EXCL.JK,2021-08-24,2750,2750,2610,2640,2594.969727,19932700,140,-110,2640,2625.714286,2580.47619,62.18252702,2680
EXCL.JK,2021-08-25,2640,2690,2630,2680,2634.287598,10913100,60,40,2644.285714,2625,2586.666667,60.78847008,2660
EXCL.JK,2021-08-26,2680,2700,2620,2660,2614.628662,12159400,80,-20,2660,2626.428571,2597.619048,51.96152423,2650
EXCL.JK,2021-08-27,2640,2680,2570,2650,2604.799316,13789800,110,10,2670,2625.714286,2609.52381,42.03173404,2670
EXCL.JK,2021-08-30,2650,2690,2650,2670,2624.458008,7667200,40,20,2665.714286,2628.571429,2620,42.37025012,2670
EXCL.JK,2021-08-31,2660,2700,2650,2670,2624.458008,10498000,50,10,2675.714286,2634.285714,2632.857143,31.0145895,2670
EXCL.JK,2021-09-01,2680,2690,2640,2670,2624.458008,6824400,50,-10,2671.428571,2642.142857,2639.047619,29.11389784,2680
EXCL.JK,2021-09-02,2680,2740,2670,2680,2634.287598,12373000,70,0,2662.857143,2651.428571,2638.095238,13.80131119,2660
EXCL.JK,2021-09-03,2690,2700,2650,2660,2614.628662,7800200,50,-30,2668.571429,2656.428571,2639.52381,10.69044968,2640
EXCL.JK,2021-09-06,2660,2680,2630,2640,2594.969727,8181800,50,-20,2665.714286,2662.857143,2639.52381,9.759000729,2640
EXCL.JK,2021-09-07,2640,2660,2600,2640,2594.969727,6058200,60,0,2662.857143,2666.428571,2638.095238,13.80131119,2610
EXCL.JK,2021-09-08,2630,2650,2580,2610,2565.481445,13956400,70,-20,2661.428571,2663.571429,2639.52381,15.73591585,2650
EXCL.JK,2021-09-09,2610,2680,2550,2650,2604.799316,22673400,130,40,2652.857143,2664.285714,2640.47619,24.29971585,2690
EXCL.JK,2021-09-10,2650,2730,2620,2690,2644.116943,15163300,110,40,2650,2660.714286,2644.761905,23.09401077,2710
EXCL.JK,2021-09-13,2680,2720,2660,2710,2663.775879,17860500,60,30,2652.857143,2657.857143,2651.904762,26.90370837,2950
EXCL.JK,2021-09-14,2700,3040,2700,2950,2899.682129,116986300,340,250,2657.142857,2662.857143,2656.666667,33.52326839,3000
EXCL.JK,2021-09-15,2940,3040,2920,3000,2948.829346,43293600,120,60,2698.571429,2682.142857,2674.761905,115.8200575,2970
EXCL.JK,2021-09-16,3000,3000,2960,2970,2919.341064,18520800,40,-30,2750,2706.428571,2694.285714,157.7973384,3000
EXCL.JK,2021-09-17,2990,3030,2960,3000,2948.829346,33427400,70,10,2797.142857,2729.285714,2708.095238,168.3957923,2980
EXCL.JK,2021-09-20,3000,3000,2880,2980,2929.17041,11036600,120,-20,2852.857143,2752.857143,2727.142857,160.4903201,3020
EXCL.JK,2021-09-21,2930,3080,2920,3020,2968.488281,34245200,160,90,2900,2775,2740.47619,137.8404875,2990
EXCL.JK,2021-09-22,3040,3080,2980,2990,2939,35953900,100,-50,2947.142857,2800,2754.285714,107.038044,2980
EXCL.JK,2021-09-23,3020,3030,2970,2980,2929.17041,9249000,60,-40,2987.142857,2822.142857,2770.952381,22.88688541,2950
EXCL.JK,2021-09-24,3000,3000,2920,2950,2899.682129,9800500,80,-50,2991.428571,2845,2785.238095,16.7616342,2890
EXCL.JK,2021-09-27,2950,3000,2820,2890,2840.705566,40972800,180,-60,2984.285714,2867.142857,2799.047619,22.25394561,2940
EXCL.JK,2021-09-28,2880,2970,2850,2940,2889.852783,22298400,120,60,2972.857143,2885,2810.47619,42.31401884,2940
EXCL.JK,2021-09-29,2940,2950,2880,2940,2889.852783,10395600,70,0,2964.285714,2908.571429,2823.333333,41.97504928,3040
EXCL.JK,2021-09-30,2900,3050,2850,3040,2988.146973,41813700,200,140,2958.571429,2929.285714,2836.190476,42.20133151,3000
EXCL.JK,2021-10-01,3030,3140,2980,3000,2948.829346,34983200,160,-30,2961.428571,2954.285714,2853.809524,47.40906082,3010
EXCL.JK,2021-10-04,3000,3040,2960,3010,2958.658691,17253000,80,10,2962.857143,2975,2869.047619,48.55041562,2920
EXCL.JK,2021-10-05,2980,2990,2850,2920,2870.193848,31680200,140,-60,2967.142857,2979.285714,2885.714286,51.54748158,2880
EXCL.JK,2021-10-06,2950,2950,2870,2880,2830.876221,14592800,80,-70,2962.857143,2973.571429,2899.047619,54.37961803,2870
EXCL.JK,2021-10-07,2910,2920,2820,2870,2821.046631,17549500,100,-40,2961.428571,2967.142857,2910.47619,56.69467095,3000
EXCL.JK,2021-10-08,2870,3020,2870,3000,2948.829346,65443700,150,130,2951.428571,2957.857143,2922.857143,66.44009117,3200
EXCL.JK,2021-10-11,3010,3250,2990,3200,3145.417969,75346600,260,190,2960,2959.285714,2939.52381,68.556546,3230
EXCL.JK,2021-10-12,3200,3270,3130,3230,3174.90625,56112700,140,30,2982.857143,2972.142857,2963.809524,112.3557276,3150
EXCL.JK,2021-10-13,3200,3210,3070,3150,3096.270752,36103300,140,-50,3015.714286,2989.285714,2988.571429,146.6125441,3170
EXCL.JK,2021-10-14,3150,3200,3120,3170,3115.929688,24245000,80,20,3035.714286,3001.428571,2998.095238,155.0115203,3150
EXCL.JK,2021-10-15,3170,3180,3120,3150,3096.270752,22726200,60,-20,3071.428571,3017.142857,3006.190476,152.6901625,3090
EXCL.JK,2021-10-18,3140,3140,3060,3090,3037.294189,22277300,80,-50,3110,3035.714286,3014.761905,128.4523258,3080
EXCL.JK,2021-10-19,3090,3130,3020,3080,3027.464844,19802500,110,-10,3141.428571,3046.428571,3019.047619,76.25146369,3080
EXCL.JK,2021-10-21,3080,3140,3040,3080,3027.464844,33226100,100,0,3152.857143,3056.428571,3023.809524,54.37961803,3110
EXCL.JK,2021-10-22,3100,3140,3060,3110,3056.953125,47481700,80,10,3135.714286,3059.285714,3026.666667,55.93363414,3080
EXCL.JK,2021-10-25,3110,3130,3020,3080,3027.464844,29079900,110,-30,3118.571429,3067.142857,3032.380952,37.60699023,3080
EXCL.JK,2021-10-26,3080,3100,3040,3080,3027.464844,24317500,60,0,3108.571429,3072.142857,3037.142857,37.16116765,3070
EXCL.JK,2021-10-27,3070,3080,3020,3070,3017.635254,19021100,60,0,3095.714286,3083.571429,3043.333333,26.367368,3020
EXCL.JK,2021-10-28,3070,3070,2960,3020,2968.488281,20802100,110,-50,3084.285714,3097.142857,3051.904762,12.72418021,3080
EXCL.JK,2021-10-29,3020,3090,3020,3080,3027.464844,21820500,70,60,3074.285714,3107.857143,3055.714286,26.99206233,3000
EXCL.JK,2021-11-01,3080,3100,2990,3000,2948.829346,28091000,110,-80,3074.285714,3113.571429,3062.380952,26.99206233,2950
EXCL.JK,2021-11-02,3000,3010,2920,2950,2899.682129,15638300,90,-50,3062.857143,3099.285714,3060.47619,38.60668583,3010
EXCL.JK,2021-11-03,2950,3010,2930,3010,2958.658691,19998700,80,60,3040,3079.285714,3058.095238,51.31601439,2970
EXCL.JK,2021-11-04,3030,3030,2950,2970,2919.341064,11877000,80,-60,3030,3069.285714,3058.095238,48.98979486,2990
EXCL.JK,2021-11-05,2950,3000,2930,2990,2939,12762000,70,40,3014.285714,3055,3060.47619,47.90864322,2990
EXCL.JK,2021-11-08,3000,3000,2960,2990,2939,8211000,40,-10,3002.857143,3043.571429,3065.714286,41.51878519,3040
EXCL.JK,2021-11-09,3000,3080,2990,3040,2988.146973,24071600,90,40,2998.571429,3036.428571,3071.428571,40.99941928,3030
EXCL.JK,2021-11-10,3050,3050,3000,3030,2978.317627,16039700,50,-20,2992.857143,3033.571429,3073.333333,28.70208222,3000
EXCL.JK,2021-11-11,3020,3020,2960,3000,2948.829346,22255600,60,-20,2997.142857,3030,3065.238095,31.99702367,3000
EXCL.JK,2021-11-12,3000,3020,2980,3000,2948.829346,10078900,40,0,3004.285714,3022.142857,3054.285714,24.39750182,2940
EXCL.JK,2021-11-15,2990,3010,2940,2940,2889.852783,10881400,70,-50,3002.857143,3016.428571,3047.142857,24.29971585,2920
EXCL.JK,2021-11-16,2920,2960,2920,2920,2870.193848,16379200,40,0,2998.571429,3006.428571,3036.190476,32.36694375,2930
EXCL.JK,2021-11-17,2950,2950,2880,2930,2880.023438,9186000,70,-20,2988.571429,2995.714286,3025.238095,44.13183712,2860
EXCL.JK,2021-11-18,2930,2930,2860,2860,2811.217285,13955300,70,-70,2980,2989.285714,3017.619048,49.32882862,2980
EXCL.JK,2021-11-19,2860,3000,2860,2980,2929.17041,26488700,140,120,2954.285714,2973.571429,3007.142857,58.83795341,2960
EXCL.JK,2021-11-22,3000,3000,2940,2960,2909.511719,11473700,60,-40,2947.142857,2972.142857,3002.380952,50.56820006,2940
EXCL.JK,2021-11-23,2960,2970,2930,2940,2889.852783,8565200,40,-20,2941.428571,2972.857143,2995.238095,45.61745698,2970
EXCL.JK,2021-11-24,2920,3000,2920,2970,2919.341064,13356900,80,50,2932.857143,2967.857143,2988.571429,37.73340064,3010
EXCL.JK,2021-11-25,2990,3070,2980,3010,2958.658691,37675300,90,20,2937.142857,2967.857143,2983.333333,40.29652,2950
EXCL.JK,2021-11-26,3010,3010,2910,2950,2899.682129,18250800,100,-60,2950,2969.285714,2980.47619,47.60952286,3000
EXCL.JK,2021-11-29,2950,3040,2950,3000,2948.829346,54572300,90,50,2952.857143,2966.428571,2977.142857,46.80252333,3070
EXCL.JK,2021-11-30,3020,3160,3010,3070,3017.635254,44680000,150,50,2972.857143,2963.571429,2973.333333,25.63479778,3070
EXCL.JK,2021-12-01,3070,3120,3040,3070,3017.635254,33311700,80,0,2985.714286,2966.428571,2976.666667,45.03966506,3150
EXCL.JK,2021-12-02,3080,3170,3040,3150,3096.270752,41740000,130,70,3001.428571,2971.428571,2982.380952,53.04984179,3140
EXCL.JK,2021-12-03,3150,3180,3100,3140,3086.441406,15129800,80,-10,3031.428571,2982.142857,2989.047619,69.38505397,3120
EXCL.JK,2021-12-06,3150,3180,3090,3120,3066.782471,16071200,90,-30,3055.714286,2996.428571,2997.142857,73.90470054,3120
EXCL.JK,2021-12-07,3120,3150,3060,3120,3066.782471,17040200,90,0,3071.428571,3010.714286,3003.333333,74.25823668,3120
EXCL.JK,2021-12-08,3120,3120,3100,3120,3066.782471,9262900,20,0,3095.714286,3024.285714,3009.52381,52.55382728,3110
EXCL.JK,2021-12-09,3120,3150,3060,3110,3056.953125,7168600,90,-10,3112.857143,3042.857143,3013.333333,31.4718317,3120
EXCL.JK,2021-12-10,3110,3130,3090,3120,3066.782471,18387300,40,10,3118.571429,3052.142857,3017.142857,25.44836041,3170
EXCL.JK,2021-12-13,3120,3210,3120,3170,3115.929688,19935500,90,50,3125.714286,3063.571429,3022.857143,13.97276262,3190
EXCL.JK,2021-12-14,3180,3200,3130,3190,3135.588623,11155800,70,10,3128.571429,3080,3030.952381,20.35400978,3130
EXCL.JK,2021-12-15,3200,3200,3130,3130,3076.612061,8638400,70,-70,3135.714286,3095.714286,3042.857143,31.0145895,3170
EXCL.JK,2021-12-16,3150,3190,3140,3170,3115.929688,8021900,50,20,3137.142857,3104.285714,3052.857143,30.39423504,3230
EXCL.JK,2021-12-17,3170,3240,3160,3230,3174.90625,17248100,80,60,3144.285714,3120,3064.285714,31.54739443,3180
EXCL.JK,2021-12-20,3230,3230,3110,3180,3125.759033,8881600,120,-50,3160,3136.428571,3081.904762,42.81744193,3170
EXCL.JK,2021-12-21,3180,3200,3140,3170,3115.929688,9417700,60,-10,3170,3144.285714,3091.428571,36.96845502,3140
EXCL.JK,2021-12-22,3170,3170,3130,3140,3086.441406,2688400,40,-30,3177.142857,3151.428571,3101.428571,29.84084768,3090
EXCL.JK,2021-12-23,3140,3150,3080,3090,3037.294189,4728500,70,-50,3172.857143,3150.714286,3110.952381,33.02235895,3080
EXCL.JK,2021-12-24,3090,3110,3070,3080,3027.464844,4162400,40,-10,3158.571429,3147.142857,3116.666667,44.13183712,3090
EXCL.JK,2021-12-27,3090,3100,3020,3090,3037.294189,6706700,80,0,3151.428571,3144.285714,3120,52.734736,3070
EXCL.JK,2021-12-28,3090,3100,3060,3070,3017.635254,4260700,40,-20,3140,3142.142857,3126.666667,56.56854249,3130
EXCL.JK,2021-12-29,3080,3160,3070,3130,3076.612061,9613900,90,50,3117.142857,3138.571429,3130,45.35573676,3170
EXCL.JK,2021-12-30,3130,3170,3100,3170,3115.929688,12685800,70,40,3110,3140,3132.857143,36.96845502,3160
EXCL.JK,2022-01-03,3180,3190,3130,3160,3106.100342,2956000,60,-20,3110,3143.571429,3137.619048,36.96845502,3140
EXCL.JK,2022-01-04,3160,3180,3130,3140,3086.441406,5378900,50,-20,3112.857143,3142.857143,3138.095238,40.29652,3090
EXCL.JK,2022-01-05,3120,3130,2930,3090,3037.294189,14991300,200,-30,3120,3139.285714,3138.095238,40,2970
EXCL.JK,2022-01-06,3090,3090,2960,2970,2919.341064,17719500,130,-120,3121.428571,3136.428571,3136.666667,38.48314411,3020
EXCL.JK,2022-01-07,2970,3040,2960,3020,2968.488281,10497500,80,50,3104.285714,3122.142857,3129.52381,69.24765769,3000
EXCL.JK,2022-01-10,3020,3090,3000,3000,2948.829346,8623900,90,-20,3097.142857,3107.142857,3124.761905,75.65586245,2930
EXCL.JK,2022-01-11,2980,3060,2920,2930,2880.023438,11313900,140,-50,3078.571429,3094.285714,3119.52381,81.94074514,2950
EXCL.JK,2022-01-12,2990,3000,2940,2950,2899.682129,4834600,60,-40,3044.285714,3077.142857,3110.47619,87.34169353,3020
EXCL.JK,2022-01-13,2950,3060,2950,3020,2968.488281,5549100,110,70,3014.285714,3063.571429,3100,76.34508123,3090
EXCL.JK,2022-01-14,3060,3150,3020,3090,3037.294189,8096800,130,30,2997.142857,3058.571429,3091.904762,53.45224838,3050
EXCL.JK,2022-01-17,3090,3130,3040,3050,2997.976563,4413700,90,-40,2997.142857,3059.285714,3090,53.45224838,2990
EXCL.JK,2022-01-18,3050,3130,2950,2990,2939,6792900,180,-60,3008.571429,3056.428571,3084.285714,55.20524475,3050
EXCL.JK,2022-01-19,2980,3050,2980,3050,2997.976563,2529100,70,70,3004.285714,3050.714286,3072.857143,55.33448077,3060
EXCL.JK,2022-01-20,3050,3100,3040,3060,3007.805908,4194100,60,10,3011.428571,3045,3066.666667,57.85861256,3050
EXCL.JK,2022-01-21,3060,3080,3040,3050,2997.976563,3348400,40,-10,3030,3037.142857,3061.428571,47.25815626,2990
EXCL.JK,2022-01-24,3050,3060,2970,2990,2939,5831400,90,-60,3044.285714,3029.285714,3057.142857,31.54739443,2940
EXCL.JK,2022-01-25,2990,3030,2940,2940,2889.852783,12342400,90,-50,3040,3018.571429,3052.380952,36.96845502,3080
EXCL.JK,2022-01-26,2940,3100,2940,3080,3027.464844,12754900,160,140,3018.571429,3007.857143,3045.714286,45.61745698,3160
EXCL.JK,2022-01-27,3100,3180,3070,3160,3106.100342,15885900,110,60,3022.857143,3015.714286,3045.238095,50.23753103,3290
EXCL.JK,2022-01-28,3200,3300,3200,3290,3233.882813,51019400,100,90,3047.142857,3025.714286,3049.52381,69.213266,3320
EXCL.JK,2022-01-31,3290,3370,3290,3320,3263.371094,20971300,80,30,3081.428571,3046.428571,3057.142857,115.0983017,3310
EXCL.JK,2022-02-02,3320,3350,3240,3310,3253.541748,16930200,110,-10,3118.571429,3074.285714,3064.285714,145.0779757,3270
EXCL.JK,2022-02-03,3310,3340,3210,3270,3214.223877,5710100,130,-40,3155.714286,3100,3071.428571,157.3591585,3190
EXCL.JK,2022-02-04,3270,3300,3180,3190,3135.588623,8016600,120,-80,3195.714286,3117.857143,3077.619048,143.1615804,3110
EXCL.JK,2022-02-07,3190,3270,3110,3110,3056.953125,9868800,160,-80,3231.428571,3125,3082.380952,90.07933012,3070
EXCL.JK,2022-02-08,3100,3150,3060,3070,3017.635254,13228900,90,-30,3235.714286,3129.285714,3089.047619,82.02786983,3070
EXCL.JK,2022-02-09,3090,3100,3050,3070,3017.635254,11534500,50,-20,3222.857143,3135,3091.428571,100.7826516,3090
EXCL.JK,2022-02-10,3070,3140,3050,3090,3037.294189,12514900,90,20,3191.428571,3136.428571,3094.761905,110.2162377,3080
EXCL.JK,2022-02-11,3090,3110,3050,3080,3027.464844,5340100,60,-10,3158.571429,3138.571429,3102.380952,99.23517042,2980
EXCL.JK,2022-02-14,3070,3070,2960,2980,2929.17041,14164900,110,-90,3125.714286,3140.714286,3108.571429,76.1264612,2980
EXCL.JK,2022-02-15,2980,3030,2970,2980,2929.17041,6084200,60,0,3084.285714,3140,3106.666667,62.14422549,2980
EXCL.JK,2022-02-16,2990,3010,2950,2980,2929.17041,9880500,60,-10,3054.285714,3142.857143,3101.428571,52.55382728,2920
EXCL.JK,2022-02-17,2960,2970,2910,2920,2870.193848,11488200,60,-40,3035.714286,3135.714286,3098.095238,52.55382728,2950
EXCL.JK,2022-02-18,2920,2980,2920,2950,2899.682129,8214100,60,30,3014.285714,3118.571429,3094.761905,65.28326556,2880
EXCL.JK,2022-02-21,2950,2980,2880,2880,2830.876221,22300400,100,-70,2997.142857,3094.285714,3090,63.95683068,2860
EXCL.JK,2022-02-22,2890,2950,2840,2860,2811.217285,25197800,110,-30,2967.142857,3062.857143,3081.428571,62.37368187,2880
EXCL.JK,2022-02-23,2870,2920,2860,2880,2830.876221,29196400,60,10,2935.714286,3030.714286,3072.380952,50.28490259,2770
EXCL.JK,2022-02-24,2890,2920,2760,2770,2722.752441,36924000,160,-120,2921.428571,3002.857143,3067.142857,49.80915961,2860
EXCL.JK,2022-02-25,2780,2900,2780,2860,2811.217285,39163600,120,80,2891.428571,2972.857143,3059.047619,68.41748593,2880
EXCL.JK,2022-03-01,2900,2930,2860,2880,2830.876221,22596900,70,-20,2874.285714,2955,3048.571429,56.52643714,2770
EXCL.JK,2022-03-02,2870,2890,2770,2770,2722.752441,26674200,120,-100,2868.571429,2941.428571,3035.238095,53.04984179,2740
EXCL.JK,2022-03-04,2770,2820,2710,2740,2693.26416,14606900,110,-30,2842.857143,2920,3010.47619,50.56820006,2640
EXCL.JK,2022-03-07,2740,2740,2600,2640,2594.969727,41669900,140,-100,2822.857143,2895,2982.857143,60.19808572,2590
EXCL.JK,2022-03-08,2640,2730,2530,2590,2545.822754,36394400,200,-50,2791.428571,2863.571429,2950.952381,88.3984486,2660
EXCL.JK,2022-03-09,2590,2670,2550,2660,2614.628662,25089400,120,70,2750,2835.714286,2918.571429,106.1445555,2680
EXCL.JK,2022-03-10,2700,2700,2610,2680,2634.287598,18200200,90,-20,2734.285714,2812.857143,2893.333333,110.7334853,2790
EXCL.JK,2022-03-11,2680,2800,2660,2790,2742.411377,27237700,140,110,2708.571429,2791.428571,2872.857143,96.68308563,2740
EXCL.JK,2022-03-14,2790,2800,2720,2740,2693.26416,13297000,80,-50,2695.714286,2782.142857,2859.52381,73.22502825,2640
EXCL.JK,2022-03-15,2730,2730,2630,2640,2594.969727,23263000,100,-90,2691.428571,2767.142857,2843.809524,68.90296835,2700
EXCL.JK,2022-03-16,2670,2720,2670,2700,2653.946533,18929100,50,30,2677.142857,2750,2822.380952,67.50661343,2640
EXCL.JK,2022-03-17,2710,2740,2630,2640,2594.969727,22038500,110,-70,2685.714286,2738.571429,2804.285714,65.79187966,2650
EXCL.JK,2022-03-18,2640,2700,2640,2650,2604.799316,13142300,60,10,2692.857143,2721.428571,2788.095238,55.5920515,2690
EXCL.JK,2022-03-21,2660,2720,2660,2690,2644.116943,15822900,60,30,2691.428571,2712.857143,2772.380952,56.69467095,2720
EXCL.JK,2022-03-22,2700,2730,2690,2720,2673.605225,9367800,40,20,2692.857143,2700.714286,2758.571429,56.48430039,2700
EXCL.JK,2022-03-23,2720,2740,2670,2700,2653.946533,18760400,70,-20,2682.857143,2689.285714,2749.047619,40.29652,2760
EXCL.JK,2022-03-24,2720,2770,2680,2760,2712.923096,19910800,90,40,2677.142857,2684.285714,2737.142857,33.02235895,2760
EXCL.JK,2022-03-25,2770,2780,2700,2760,2712.923096,28565500,80,-10,2694.285714,2685.714286,2731.428571,40.76646614,2790
EXCL.JK,2022-03-28,2770,2840,2770,2790,2742.411377,28344700,70,20,2702.857143,2694.285714,2726.666667,47.85891965,2760
EXCL.JK,2022-03-29,2790,2800,2750,2760,2712.923096,14517600,50,-30,2724.285714,2708.571429,2722.380952,48.5994317,2710
EXCL.JK,2022-03-30,2760,2780,2700,2710,2663.775879,11013600,80,-50,2740,2715.714286,2721.904762,36.96845502,2650
EXCL.JK,2022-03-31,2710,2710,2640,2650,2604.799316,22069300,70,-60,2742.857143,2717.857143,2714.761905,33.02235895,2610
EXCL.JK,2022-04-01,2640,2650,2590,2610,2565.481445,19629400,60,-30,2732.857143,2707.857143,2703.809524,48.20590756,2680
EXCL.JK,2022-04-04,2610,2690,2610,2680,2634.287598,16122000,80,70,2720,2698.571429,2696.190476,66.83312552,2700
EXCL.JK,2022-04-05,2680,2720,2680,2700,2653.946533,16777500,40,20,2708.571429,2701.428571,2693.333333,65.68322247,2700
EXCL.JK,2022-04-06,2690,2760,2680,2700,2653.946533,16466700,80,10,2700,2701.428571,2696.190476,61.64414003,2660
EXCL.JK,2022-04-07,2710,2730,2660,2660,2614.628662,15861600,70,-50,2687.142857,2705.714286,2701.428571,47.50939757,2690
EXCL.JK,2022-04-08,2670,2720,2660,2690,2644.116943,15891300,60,20,2672.857143,2706.428571,2701.428571,35.45621042,2580
EXCL.JK,2022-04-11,2690,2690,2550,2580,2535.993164,32565300,140,-110,2670,2706.428571,2701.904762,32.65986324,2570
EXCL.JK,2022-04-12,2580,2610,2550,2570,2526.163818,14278200,60,-10,2660,2696.428571,2691.904762,47.25815626,2720
EXCL.JK,2022-04-13,2590,2780,2580,2720,2673.605225,49700000,200,130,2654.285714,2687.142857,2683.809524,55.93363414,2710
EXCL.JK,2022-04-14,2750,2760,2690,2710,2663.775879,21968200,70,-40,2660,2684.285714,2687.619048,60.8276253,2940
EXCL.JK,2022-04-18,2730,2950,2720,2940,2889.852783,73450800,230,210,2661.428571,2680.714286,2688.095238,62.029179,2950
EXCL.JK,2022-04-19,2940,2950,2870,2950,2899.682129,24148700,80,10,2695.714286,2691.428571,2702.380952,123.1336865,3180
EXCL.JK,2022-04-20,2970,3280,2960,3180,3125.759033,95096000,320,210,2737.142857,2705,2716.666667,154.0253535,3240
EXCL.JK,2022-04-21,3180,3300,3120,3240,3184.735596,50212200,180,60,2807.142857,2738.571429,2740,224.3296893,3160
EXCL.JK,2022-04-22,3230,3230,3130,3160,3106.100342,33912400,100,-70,2901.428571,2780.714286,2764.761905,250.1618524,3290
EXCL.JK,2022-04-25,3220,3290,3160,3290,3233.882813,40134600,130,70,2985.714286,2820,2786.666667,217.0911593,3200
EXCL.JK,2022-04-26,3300,3380,3200,3200,3145.417969,42770200,180,-100,3067.142857,2863.571429,2811.904762,207.5021515,3180
EXCL.JK,2022-04-27,3160,3220,3130,3180,3125.759033,23364600,90,20,3137.142857,2899.285714,2832.857143,137.9268267,3190
EXCL.JK,2022-04-28,3220,3250,3170,3190,3135.588623,21720800,80,-30,3171.428571,2933.571429,2851.428571,107.1492062,3040
EXCL.JK,2022-05-09,3150,3150,2990,3040,2988.146973,25744500,160,-110,3205.714286,2971.428571,2871.904762,44.66808811,2990
EXCL.JK,2022-05-10,3040,3120,2980,2990,2939,57369100,140,-50,3185.714286,2996.428571,2887.619048,77.42892286,2990
EXCL.JK,2022-05-11,2980,3000,2940,2990,2990,20468200,60,10,3150,3025.714286,2903.809524,101.9803903,2790
EXCL.JK,2022-05-12,2990,2990,2790,2790,2790,21577500,200,-200,3125.714286,3055.714286,2921.904762,118.1605042,2850
EXCL.JK,2022-05-13,2830,2860,2740,2850,2850,29174700,120,20,3054.285714,3060.714286,2927.142857,149.3159003,2790
EXCL.JK,2022-05-17,2850,2870,2750,2790,2790,16414900,120,-60,3004.285714,3070.714286,2934.285714,150.9809196,2710
EXCL.JK,2022-05-18,2820,2820,2660,2710,2710,21749900,160,-110,2948.571429,3060,2938.571429,147.2445326,2660
EXCL.JK,2022-05-19,2670,2700,2620,2660,2660,17144000,80,-10,2880,3042.857143,2940.952381,126.3592761,2690
EXCL.JK,2022-05-20,2660,2700,2640,2690,2690,15492000,60,30,2825.714286,3005.714286,2939.52381,127.7832987,2600
EXCL.JK,2022-05-23,2700,2710,2580,2600,2600,23738300,130,-100,2782.857143,2966.428571,2944.761905,112.9475226,2600
EXCL.JK,2022-05-24,2670,2670,2580,2600,2600,13737100,90,-70,2727.142857,2926.428571,2946.190476,86.93182879,2570
EXCL.JK,2022-05-25,2600,2630,2570,2570,2570,11908400,60,-30,2700,2877.142857,2940.47619,93.45230513,2670
EXCL.JK,2022-05-27,2610,2700,2590,2670,2670,27422300,110,60,2660,2832.142857,2933.809524,77.02813339,2690
EXCL.JK,2022-05-30,2700,2700,2630,2690,2690,13122600,70,-10,2642.857143,2795.714286,2920.952381,52.82495803,2640
EXCL.JK,2022-05-31,2690,2710,2640,2640,2640,27409400,70,-50,2640,2760,2908.571429,48.98979486,2680
EXCL.JK,2022-06-02,2640,2710,2580,2680,2680,42788300,130,40,2637.142857,2731.428571,2882.857143,48.20590756,2640
EXCL.JK,2022-06-03,2690,2740,2630,2640,2640,23988000,110,-50,2635.714286,2709.285714,2856.190476,46.49628761,2570
EXCL.JK,2022-06-06,2630,2630,2550,2570,2570,38358200,80,-60,2641.428571,2684.285714,2831.428571,43.75255095,2590
EXCL.JK,2022-06-07,2580,2620,2560,2590,2590,23493100,60,10,2637.142857,2668.571429,2797.142857,49.56957592,2670
EXCL.JK,2022-06-08,2600,2680,2570,2670,2670,38782400,110,70,2640,2650,2768.095238,45.46060566,2600
EXCL.JK,2022-06-09,2670,2670,2600,2600,2600,26752200,70,-70,2640,2641.428571,2743.809524,45.46060566,2560
EXCL.JK,2022-06-10,2560,2600,2550,2560,2560,27034000,50,0,2627.142857,2633.571429,2715.714286,41.51878519,2410
EXCL.JK,2022-06-13,2500,2500,2390,2410,2410,40408400,110,-90,2615.714286,2626.428571,2692.857143,47.90864322,2440
EXCL.JK,2022-06-14,2410,2470,2390,2440,2440,23564400,80,30,2577.142857,2606.428571,2665.238095,83.2094317,2410
EXCL.JK,2022-06-15,2440,2460,2340,2410,2410,33293500,120,-30,2548.571429,2595,2639.047619,91.91092997,2380
EXCL.JK,2022-06-16,2470,2470,2380,2380,2380,20872600,90,-90,2525.714286,2581.428571,2620.952381,104.6991154,2330
EXCL.JK,2022-06-17,2350,2370,2250,2330,2330,47456300,120,-20,2495.714286,2567.857143,2598.571429,112.9686008,2320
EXCL.JK,2022-06-20,2330,2330,2230,2320,2320,31233700,100,-10,2447.142857,2543.571429,2576.666667,97.59000729,2500
EXCL.JK,2022-06-21,2330,2520,2330,2500,2500,52556300,190,170,2407.142857,2517.142857,2558.095238,80.3563492,2480
EXCL.JK,2022-06-22,2500,2510,2430,2480,2480,25184700,80,-20,2398.571429,2507.142857,2550.47619,62.56425269,2670
EXCL.JK,2022-06-23,2500,2670,2500,2670,2670,63068800,170,170,2408.571429,2492.857143,2540.47619,69.8638131,2630
EXCL.JK,2022-06-24,2680,2720,2610,2630,2630,28862400,110,-50,2441.428571,2495,2543.809524,121.8508065,2680
EXCL.JK,2022-06-27,2630,2680,2580,2680,2680,19883200,100,50,2472.857143,2499.285714,2545.238095,139.4888628,2630
EXCL.JK,2022-06-28,2690,2700,2610,2630,2630,7069900,90,-60,2515.714286,2505.714286,2550.47619,151.7516769,2550
EXCL.JK,2022-06-29,2610,2620,2530,2550,2550,13093700,90,-60,2558.571429,2502.857143,2548.571429,131.5837593,2600
EXCL.JK,2022-06-30,2550,2650,2510,2600,2600,11701200,140,50,2591.428571,2499.285714,2541.904762,81.12306935,2560
EXCL.JK,2022-07-01,2600,2610,2540,2560,2560,5317700,70,-40,2605.714286,2502.142857,2540,70.44078905,2400
EXCL.JK,2022-07-04,2570,2600,2400,2400,2400,17278200,200,-170,2617.142857,2512.857143,2534.285714,50.23753103,2380
EXCL.JK,2022-07-05,2400,2420,2350,2380,2380,18523700,70,-20,2578.571429,2510,2522.857143,90.44861735,2240
EXCL.JK,2022-07-06,2360,2360,2240,2240,2240,31908700,120,-120,2542.857143,2507.857143,2513.809524,113.2422603,2260
EXCL.JK,2022-07-07,2240,2290,2210,2260,2260,21830400,80,20,2480,2497.857143,2497.142857,142.7118309,2300
EXCL.JK,2022-07-08,2290,2340,2270,2300,2300,29937200,70,10,2427.142857,2492.857143,2477.619048,146.368745,2250
EXCL.JK,2022-07-11,2310,2310,2230,2250,2250,9276700,80,-60,2391.428571,2491.428571,2463.333333,141.8248417,2300
EXCL.JK,2022-07-12,2260,2320,2250,2300,2300,16428700,70,40,2341.428571,2473.571429,2448.571429,115.2430145,2300
EXCL.JK,2022-07-13,2300,2370,2260,2300,2300,30265600,110,0,2304.285714,2460.714286,2443.333333,63.20789583,2280
EXCL.JK,2022-07-14,2300,2360,2260,2280,2280,12930000,100,-20,2290,2434.285714,2436.666667,47.25815626,2320
EXCL.JK,2022-07-15,2280,2360,2260,2320,2320,17830600,100,40,2275.714286,2409.285714,2430.47619,25.72750983,2340
EXCL.JK,2022-07-18,2340,2360,2290,2340,2340,14579700,70,0,2287.142857,2383.571429,2427.619048,24.97617913,2500
EXCL.JK,2022-07-19,2390,2500,2350,2500,2500,37510200,150,110,2298.571429,2362.857143,2428.095238,28.53569194,2530
EXCL.JK,2022-07-20,2520,2600,2450,2530,2530,30210700,150,10,2327.142857,2359.285714,2436.666667,81.38678961,2460
EXCL.JK,2022-07-21,2500,2520,2440,2460,2460,11081000,80,-40,2367.142857,2354.285714,2438.095238,103.0718658,2460
EXCL.JK,2022-07-22,2460,2480,2440,2460,2460,8307200,40,0,2390,2347.142857,2437.142857,103.4408043,2450
EXCL.JK,2022-07-25,2460,2470,2430,2450,2450,17109500,40,-10,2412.857143,2351.428571,2427.142857,97.76064063,2380
EXCL.JK,2022-07-26,2400,2420,2370,2380,2380,14518000,50,-20,2437.142857,2356.428571,2418.571429,78.46746368,2370
EXCL.JK,2022-07-27,2380,2400,2360,2370,2370,11660800,40,-10,2445.714286,2366.428571,2404.285714,65.79187966,2380
EXCL.JK,2022-07-28,2420,2430,2350,2380,2380,32689100,80,-40,2450,2374.285714,2391.904762,58.30951895,2370
EXCL.JK,2022-07-29,2380,2400,2330,2370,2370,58053600,70,-10,2432.857143,2380,2383.809524,58.79747322,2410
EXCL.JK,2022-08-01,2370,2440,2370,2410,2410,35009600,70,40,2410,2388.571429,2372.857143,43.96968653,2400
EXCL.JK,2022-08-02,2430,2430,2350,2400,2400,26158200,80,-30,2402.857143,2396.428571,2365.714286,38.17254062,2580
EXCL.JK,2022-08-03,2400,2620,2380,2580,2580,88429400,240,180,2394.285714,2403.571429,2365.714286,28.78491669,2590
EXCL.JK,2022-08-04,2600,2630,2540,2590,2590,32466400,90,-10,2412.857143,2425,2375.238095,75.21398046,2600
EXCL.JK,2022-08-05,2610,2630,2560,2600,2600,17187800,70,-10,2442.857143,2444.285714,2391.904762,98.27076298,2620
EXCL.JK,2022-08-08,2600,2630,2570,2620,2620,22856700,60,20,2475.714286,2462.857143,2408.095238,107.8358541,2610
EXCL.JK,2022-08-09,2620,2680,2600,2610,2610,30914100,80,-10,2510,2471.428571,2423.333333,110.4536102,2720
EXCL.JK,2022-08-10,2580,2730,2520,2720,2720,50292300,210,140,2544.285714,2477.142857,2440.47619,96.06545388,2750
EXCL.JK,2022-08-11,2750,2760,2690,2750,2750,36698700,70,0,2588.571429,2495.714286,2460.47619,95.29403119,2770
EXCL.JK,2022-08-12,2740,2780,2730,2770,2770,19249000,50,30,2638.571429,2516.428571,2481.904762,67.68273326,2730
EXCL.JK,2022-08-15,2770,2770,2690,2730,2730,9640700,80,-40,2665.714286,2539.285714,2505.238095,77.64387567,2640
EXCL.JK,2022-08-16,2730,2750,2600,2640,2640,21999600,150,-90,2685.714286,2564.285714,2524.761905,72.76838665,2600
EXCL.JK,2022-08-18,2630,2630,2580,2600,2600,9904800,50,-30,2691.428571,2583.571429,2539.047619,66.18876325,2600
EXCL.JK,2022-08-19,2600,2660,2570,2600,2600,12535600,90,0,2688.571429,2599.285714,2543.809524,70.10196655,2530
EXCL.JK,2022-08-22,2600,2610,2510,2530,2530,14000100,100,-70,2687.142857,2615.714286,2547.142857,72.04495951,2660
EXCL.JK,2022-08-23,2540,2680,2540,2660,2660,39933600,140,120,2660,2624.285714,2550.47619,90.92121131,2670
EXCL.JK,2022-08-24,2700,2700,2610,2670,2670,23467000,90,-30,2647.142857,2642.857143,2560,81.99883855,2680
EXCL.JK,2022-08-25,2680,2710,2650,2680,2680,15040200,60,0,2632.857143,2649.285714,2570.47619,63.69570517,2700
EXCL.JK,2022-08-26,2680,2700,2660,2700,2700,12082800,40,20,2625.714286,2655.714286,2584.761905,52.8700113,2640
EXCL.JK,2022-08-29,2650,2670,2570,2640,2640,13251100,100,-10,2634.285714,2662.857143,2600.47619,59.96030433,2730
EXCL.JK,2022-08-30,2690,2750,2670,2730,2730,17098700,80,40,2640,2664.285714,2612.857143,58.02298395,2630
EXCL.JK,2022-08-31,2730,2730,2620,2630,2630,19630000,110,-100,2658.571429,2672.857143,2630,63.62090103,2680
EXCL.JK,2022-09-01,2640,2690,2640,2680,2680,11250000,50,40,2672.857143,2666.428571,2640.47619,34.50327797,2630
EXCL.JK,2022-09-02,2680,2680,2630,2630,2630,21418900,50,-50,2675.714286,2661.428571,2653.809524,34.08672413,2640
EXCL.JK,2022-09-05,2630,2680,2610,2640,2640,16940500,70,10,2670,2651.428571,2656.190476,38.29708431,2620
EXCL.JK,2022-09-06,2640,2690,2610,2620,2620,22382200,80,-20,2664.285714,2645,2658.571429,39.5209408,2620
EXCL.JK,2022-09-07,2610,2660,2600,2620,2620,22786300,60,10,2652.857143,2643.571429,2659.52381,39.03600292,2700
EXCL.JK,2022-09-08,2640,2720,2620,2700,2700,28372200,100,60,2650,2645,2659.52381,40.82482905,2670
EXCL.JK,2022-09-09,2700,2710,2640,2670,2670,18614800,70,-30,2645.714286,2652.142857,2663.809524,31.54739443,2640
EXCL.JK,2022-09-12,2670,2680,2630,2640,2640,16463100,50,-30,2651.428571,2662.142857,2661.428571,31.84785259,2650
EXCL.JK,2022-09-13,2650,2690,2630,2650,2650,16819600,60,0,2645.714286,2660.714286,2656.190476,29.35821456,2590
EXCL.JK,2022-09-14,2620,2640,2590,2590,2590,19206100,50,-30,2648.571429,2659.285714,2650.47619,28.53569194,2580
EXCL.JK,2022-09-15,2600,2660,2580,2580,2580,24934100,80,-20,2641.428571,2652.857143,2643.809524,36.25307869,2500
EXCL.JK,2022-09-16,2580,2580,2470,2500,2500,31295200,110,-80,2635.714286,2644.285714,2640.952381,42.76179871,0