TICKER,Date,Open,High,Low,Close,Adj Close,Volume,H-L,C-O,7 DAYS MA,14 DAYS MA,21 DAYS MA,7 DAYS STD DEV,Next Day Close
ISAT.JK,2018-10-17,2620,2670,2600,2600,2253.762695,389400,70,-20,2728.571429,2807.857143,2863.333333,53.67450401,2650
ISAT.JK,2018-10-18,2600,2680,2600,2650,2297.104248,368600,80,50,2702.857143,2779.285714,2846.190476,66.51172471,2680
ISAT.JK,2018-10-19,2650,2720,2650,2680,2323.109131,259900,70,30,2688.571429,2750.714286,2830.952381,65.42898731,2840
ISAT.JK,2018-10-22,2750,3240,2690,2840,2461.802246,14470000,550,90,2677.142857,2730,2816.666667,57.36267245,2660
ISAT.JK,2018-10-23,2800,2880,2660,2660,2305.772461,3686200,220,-140,2691.428571,2727.142857,2809.047619,82.54868693,2620
ISAT.JK,2018-10-24,2660,2680,2610,2620,2271.099365,1060600,70,-40,2678.571429,2717.142857,2793.809524,78.83074092,2510
ISAT.JK,2018-10-25,2600,2600,2490,2510,2175.747803,2088600,110,-90,2667.142857,2707.857143,2778.095238,80.97618698,2470
ISAT.JK,2018-10-26,2570,2570,2470,2470,2141.074463,943000,100,-100,2651.428571,2690,2755.714286,100.0714031,2450
ISAT.JK,2018-10-29,2470,2570,2450,2450,2123.738037,1378800,120,-20,2632.857143,2667.857143,2730.47619,121.0666876,2440
ISAT.JK,2018-10-30,2450,2470,2420,2440,2115.06958,1077400,50,-10,2604.285714,2646.428571,2701.904762,138.6671245,2410
ISAT.JK,2018-10-31,2440,2450,2400,2410,2089.064453,771800,50,-30,2570,2623.571429,2676.666667,146.2873884,2430
ISAT.JK,2018-11-01,2410,2430,2400,2430,2106.401123,636500,30,20,2508.571429,2600,2654.285714,95.46876827,2350
ISAT.JK,2018-11-02,2450,2450,2320,2350,2037.054565,1519100,130,-100,2475.714286,2577.142857,2636.666667,71.14706432,2350
ISAT.JK,2018-11-05,2350,2420,2350,2350,2037.054565,241800,70,0,2437.142857,2552.142857,2617.619048,49.90467103,2350
ISAT.JK,2018-11-06,2370,2400,2350,2350,2037.054565,754800,50,-20,2414.285714,2532.857143,2598.095238,47.55948656,2320
ISAT.JK,2018-11-07,2380,2380,2320,2320,2011.049805,505300,60,-60,2397.142857,2515,2577.619048,45.72172559,2290
ISAT.JK,2018-11-08,2350,2360,2290,2290,1985.044678,2305400,70,-60,2378.571429,2491.428571,2557.142857,47.05619741,2250
ISAT.JK,2018-11-09,2290,2320,2230,2250,1950.37146,954000,90,-40,2357.142857,2463.571429,2534.761905,48.55041562,2150
ISAT.JK,2018-11-12,2250,2250,2150,2150,1863.688477,811300,100,-100,2334.285714,2421.428571,2511.428571,56.52643714,2160
ISAT.JK,2018-11-13,2150,2200,2100,2160,1872.356567,276000,100,10,2294.285714,2385,2482.857143,73.90470054,2120
ISAT.JK,2018-11-14,2180,2180,2120,2120,1837.68335,181700,60,-60,2267.142857,2352.142857,2457.142857,84.20496536,2100
ISAT.JK,2018-11-15,2120,2140,2100,2100,1820.346802,1092800,40,-20,2234.285714,2324.285714,2433.333333,91.07819769,2180
ISAT.JK,2018-11-16,2110,2290,2110,2180,1889.693237,680600,180,70,2198.571429,2297.857143,2409.52381,87.06866475,2160
ISAT.JK,2018-11-19,2180,2220,2140,2160,1872.356567,240500,80,-20,2178.571429,2278.571429,2387.142857,68.66065623,2160
ISAT.JK,2018-11-20,2160,2160,2160,2160,1872.356567,0,0,0,2160,2258.571429,2362.380952,47.95831523,2130
ISAT.JK,2018-11-21,2160,2170,2130,2130,1846.351685,144700,40,-30,2147.142857,2240.714286,2330,27.51622898,2120
ISAT.JK,2018-11-22,2130,2160,2100,2120,1837.68335,753100,60,-10,2144.285714,2219.285714,2304.761905,28.19996623,2110
ISAT.JK,2018-11-23,2130,2150,2100,2110,1829.015137,448200,50,-20,2138.571429,2202.857143,2280.952381,28.53569194,2030
ISAT.JK,2018-11-26,2110,2140,2010,2030,1759.668457,766400,130,-80,2137.142857,2185.714286,2261.904762,29.84084768,2050
ISAT.JK,2018-11-27,2030,2140,2030,2050,1777.005249,997100,110,20,2127.142857,2162.857143,2240.952381,49.56957592,2080
ISAT.JK,2018-11-28,2070,2110,2060,2080,1803.010132,157100,50,10,2108.571429,2143.571429,2221.904762,50.80307452,2030
ISAT.JK,2018-11-29,2080,2160,1990,2030,1759.668457,915000,170,-50,2097.142857,2128.571429,2204.761905,46.08480795,1985
ISAT.JK,2018-11-30,2050,2060,1985,1985,1720.661133,1504500,75,-65,2078.571429,2112.857143,2186.666667,42.5944329,2080
ISAT.JK,2018-12-03,2000,2080,2000,2080,1803.010132,1017100,80,80,2057.857143,2101.071429,2165.47619,48.29226498,2030
ISAT.JK,2018-12-04,2100,2120,2020,2030,1759.668457,723000,100,-70,2052.142857,2095.357143,2152.619048,41.61902038,1990
ISAT.JK,2018-12-05,2030,2030,1985,1990,1724.995361,1780200,45,-40,2040.714286,2088.928571,2137.380952,33.22004558,1965
ISAT.JK,2018-12-06,2000,2020,1960,1965,1703.324463,874900,60,-35,2035,2081.071429,2120.238095,38.40572874,1945
ISAT.JK,2018-12-07,1970,1980,1920,1945,1685.987793,2380900,60,-25,2022.857143,2065.714286,2103.333333,45.63050358,1885
ISAT.JK,2018-12-10,1950,1970,1885,1885,1633.977905,1709400,85,-65,2003.571429,2050.357143,2086.904762,45.98136268,1850
ISAT.JK,2018-12-11,1895,1895,1835,1850,1603.638794,1196100,60,-45,1982.857143,2030.714286,2069.52381,61.97157567,1810
ISAT.JK,2018-12-12,1850,1875,1795,1810,1568.965454,2122600,80,-40,1963.571429,2010.714286,2055.238095,79.67194643,1790
ISAT.JK,2018-12-13,1820,1825,1775,1790,1551.628906,2399000,50,-30,1925,1988.571429,2038.571429,79.26747967,1820
ISAT.JK,2018-12-14,1800,1855,1790,1820,1577.633789,1182700,65,20,1890.714286,1965.714286,2022.857143,78.17867204,1785
ISAT.JK,2018-12-17,1830,1840,1775,1785,1547.294678,1615500,65,-45,1866.428571,1950.714286,2009.52381,67.92853387,1755
ISAT.JK,2018-12-18,1780,1835,1745,1755,1521.289795,1167500,90,-25,1840.714286,1931.785714,1990.714286,57.69377288,1735
ISAT.JK,2018-12-19,1765,1770,1735,1735,1503.953125,1594100,35,-30,1813.571429,1908.571429,1971.428571,43.3699479,1745
ISAT.JK,2018-12-20,1740,1760,1735,1745,1512.62146,947000,25,5,1792.142857,1887.5,1951.190476,39.03600292,1730
ISAT.JK,2018-12-21,1745,1745,1715,1730,1499.619019,1943100,30,-15,1777.142857,1870.357143,1932.857143,32.769033,1730
ISAT.JK,2018-12-24,1730,1730,1730,1730,1499.619019,0,0,0,1765.714286,1845.357143,1914.285714,33.34523597,1730
ISAT.JK,2018-12-25,1730,1730,1730,1730,1499.619019,0,0,0,1757.142857,1823.928571,1896.190476,33.77093707,1700
ISAT.JK,2018-12-26,1725,1725,1675,1700,1473.614014,961800,50,-25,1744.285714,1805.357143,1881.904762,20.29543697,1690
ISAT.JK,2018-12-27,1710,1715,1685,1690,1464.945679,413400,30,-20,1732.142857,1786.428571,1865.238095,17.04336206,1685
ISAT.JK,2018-12-28,1700,1700,1685,1685,1460.611572,916400,15,-15,1722.857143,1768.214286,1846.666667,19.97021592,1685
ISAT.JK,2018-12-31,1685,1685,1685,1685,1460.611572,0,0,0,1715.714286,1753.928571,1830.238095,23.5280987,1685
ISAT.JK,2019-01-01,1685,1685,1685,1685,1460.611572,0,0,0,1707.142857,1742.142857,1815.952381,21.95775164,1645
ISAT.JK,2019-01-02,1685,1690,1645,1645,1425.938354,933700,45,-40,1700.714286,1733.214286,1797.142857,20.70196678,1650
ISAT.JK,2019-01-03,1645,1680,1645,1650,1430.272461,1670200,35,5,1688.571429,1722.857143,1778.809524,25.11876551,1725
ISAT.JK,2019-01-04,1655,1785,1655,1725,1495.28479,2955600,130,70,1677.142857,1710.714286,1762.619048,20.98752464,1765
ISAT.JK,2019-01-07,1745,1805,1740,1765,1529.95813,5718800,65,20,1680.714286,1706.428571,1751.190476,26.83725201,1805
ISAT.JK,2019-01-08,1775,1830,1775,1805,1564.63147,8600100,55,30,1691.428571,1707.142857,1742.619048,41.90408549,2250
ISAT.JK,2019-01-09,1840,2250,1835,2250,1950.37146,78808600,415,410,1708.571429,1712.142857,1738.809524,59.63180679,1945
ISAT.JK,2019-01-10,2100,2100,1890,1945,1685.987793,35247300,210,-155,1789.285714,1748.214286,1757.857143,211.4716012,1975
ISAT.JK,2019-01-11,1950,2010,1945,1975,1711.992798,6310200,65,25,1826.428571,1763.571429,1764.285714,212.9302367,2100
ISAT.JK,2019-01-14,1975,2120,1960,2100,1820.346802,14616500,160,125,1873.571429,1781.071429,1773.095238,202.3345885,2130
ISAT.JK,2019-01-15,2140,2160,2050,2130,1846.351685,10217900,110,-10,1937.857143,1807.5,1786.428571,190.6099233,2100
ISAT.JK,2019-01-16,2130,2210,2100,2100,1820.346802,12134200,110,-30,1995.714286,1838.214286,1802.857143,176.1492873,2040
ISAT.JK,2019-01-17,2100,2140,2010,2040,1768.336914,2893700,130,-60,2043.571429,1867.5,1819.285714,145.937038,2120
ISAT.JK,2019-01-18,2060,2120,2050,2120,1837.68335,3444100,70,60,2077.142857,1892.857143,1833.809524,102.4636986,2090
ISAT.JK,2019-01-21,2140,2160,2070,2090,1811.678345,2396500,90,-50,2058.571429,1923.928571,1851.666667,73.63843458,2380
ISAT.JK,2019-01-22,2100,2590,2060,2380,2063.05957,45643300,530,280,2079.285714,1952.857143,1868.809524,54.19321694,2960
ISAT.JK,2019-01-23,2390,2970,2350,2960,2565.822021,59472800,620,570,2137.142857,2005.357143,1899.761905,110.8624201,2880
ISAT.JK,2019-01-24,2970,3190,2850,2880,2496.475586,48583900,340,-90,2260,2098.928571,1958.333333,327.5667871,2700
ISAT.JK,2019-01-25,2900,2900,2700,2700,2340.445801,12039500,200,-200,2367.142857,2181.428571,2014.52381,393.8999148,2750
ISAT.JK,2019-01-28,2710,3020,2630,2750,2383.787354,30278100,390,40,2452.857143,2248.214286,2062.619048,391.3529645,2690
ISAT.JK,2019-01-29,2780,2810,2630,2690,2331.777588,7087700,180,-90,2554.285714,2315.714286,2113.333333,357.0180734,2690
ISAT.JK,2019-01-30,2700,2780,2630,2690,2331.777588,15693100,150,-10,2635.714286,2347.142857,2161.190476,302.2613187,2740
ISAT.JK,2019-01-31,2720,2790,2700,2740,2375.119141,12839900,90,20,2721.428571,2400.357143,2209.047619,183.4328734,2920
ISAT.JK,2019-02-01,2750,2940,2720,2920,2531.148926,48055300,220,170,2772.857143,2455,2261.190476,105.7850471,3100
ISAT.JK,2019-02-04,2950,3160,2880,3100,2687.178467,60997000,280,150,2767.142857,2513.571429,2321.666667,94.46591726,3100
ISAT.JK,2019-02-05,3100,3100,3100,3100,2687.178467,0,0,0,2798.571429,2582.857143,2387.142857,155.2877513,3300
ISAT.JK,2019-02-06,3100,3350,3100,3300,2860.544922,40858800,250,200,2855.714286,2654.285714,2450.714286,183.9254507,3490
ISAT.JK,2019-02-07,3300,3590,3300,3490,3025.24292,39122700,290,190,2934.285714,2744.285714,2521.904762,240.1289336,3460
ISAT.JK,2019-02-08,3530,3560,3390,3460,2999.238037,14783300,170,-70,3048.571429,2842.142857,2580.952381,289.7371551,3520
ISAT.JK,2019-02-11,3450,3680,3420,3520,3051.247803,24296000,260,70,3158.571429,2940,2653.095238,276.7928571,3260
ISAT.JK,2019-02-12,3510,3570,3140,3260,2825.871582,26491500,430,-250,3270,3021.428571,2726.666667,233.8803113,3200
ISAT.JK,2019-02-13,3280,3400,3150,3200,2773.861572,14872000,250,-80,3318.571429,3042.857143,2781.904762,177.6164943,3750
ISAT.JK,2019-02-14,3250,3760,3200,3750,3250.619141,48687600,560,500,3332.857143,3065.714286,2832.857143,160.2824887,3700
ISAT.JK,2019-02-15,3750,3790,3500,3700,3207.277588,25485200,290,-50,3425.714286,3140.714286,2911.428571,188.6670032,3700
ISAT.JK,2019-02-18,3730,3790,3620,3700,3207.277588,13683800,170,-30,3482.857143,3208.571429,2990.47619,204.1824581,3600
ISAT.JK,2019-02-19,3700,3700,3510,3600,3120.594482,17902200,190,-100,3512.857143,3280.714286,3065.714286,220.2055317,3600
ISAT.JK,2019-02-20,3610,3740,3550,3600,3120.594482,10185400,190,-10,3532.857143,3345.714286,3137.619048,220.9611041,3610
ISAT.JK,2019-02-21,3620,3720,3550,3610,3129.262939,7663200,170,-10,3544.285714,3407.142857,3195.714286,222.250395,3430
ISAT.JK,2019-02-22,3620,3650,3370,3430,2973.233154,9948500,280,-190,3594.285714,3456.428571,3226.666667,183.6534003,3400
ISAT.JK,2019-02-25,3450,3510,3320,3400,2947.228027,9841800,190,-50,3627.142857,3480,3252.857143,105.1529498,3150
ISAT.JK,2019-02-26,3410,3450,3100,3150,2730.52002,10931100,350,-260,3577.142857,3501.428571,3286.190476,119.2636136,3250
ISAT.JK,2019-02-27,3170,3330,3090,3250,2817.203369,7979600,240,80,3498.571429,3490.714286,3305.238095,186.8536478,3300
ISAT.JK,2019-02-28,3270,3320,3110,3300,2860.544922,5915000,210,30,3434.285714,3473.571429,3331.904762,183.3809462,3320
ISAT.JK,2019-03-01,3310,3420,3260,3320,2877.881348,8330400,160,10,3391.428571,3462.142857,3360.952381,172.9574679,3180
ISAT.JK,2019-03-04,3320,3350,3170,3180,2756.525146,3923700,180,-140,3351.428571,3447.857143,3388.571429,147.1312987,3180
ISAT.JK,2019-03-05,3180,3250,3120,3180,2756.525146,6469400,130,0,3290,3442.142857,3400.952381,104.8808848,3050
ISAT.JK,2019-03-06,3180,3180,3010,3050,2643.836914,5804000,170,-130,3254.285714,3440.714286,3404.761905,90.89502056,3050
ISAT.JK,2019-03-07,3050,3050,3050,3050,2643.836914,0,0,0,3204.285714,3390.714286,3402.380952,93.60504667,2830
ISAT.JK,2019-03-08,3040,3070,2790,2830,2453.133789,7734100,280,-210,3190,3344.285714,3390.47619,109.5445115,2770
ISAT.JK,2019-03-11,2830,2840,2720,2770,2401.124023,4913100,120,-60,3130,3282.142857,3359.047619,169.7056275,2670
ISAT.JK,2019-03-12,2730,2770,2650,2670,2314.440918,2714200,120,-60,3054.285714,3222.857143,3326.190476,197.218757,2790
ISAT.JK,2019-03-13,2690,2860,2680,2790,2418.460693,7779900,180,100,2961.428571,3156.428571,3285.714286,204.1591349,2710
ISAT.JK,2019-03-14,2820,2840,2670,2710,2349.114014,4124000,170,-110,2905.714286,3097.857143,3263.333333,187.0701422,2740
ISAT.JK,2019-03-15,2720,2780,2710,2740,2375.119141,2324800,70,20,2838.571429,3046.428571,3240,153.5609077,2910
ISAT.JK,2019-03-18,2730,2920,2730,2910,2522.480469,7696200,190,180,2794.285714,2999.285714,3191.904762,124.3459077,3010
ISAT.JK,2019-03-19,3040,3100,2950,3010,2609.163574,8907800,150,-30,2774.285714,2982.142857,3154.285714,79.55231881,2920
ISAT.JK,2019-03-20,2980,3040,2890,2920,2531.148926,2856800,150,-60,2800,2965,3121.428571,119.5826074,2870
ISAT.JK,2019-03-21,2900,2980,2870,2870,2487.807373,3232400,110,-30,2821.428571,2937.857143,3089.047619,126.5475631,2830
ISAT.JK,2019-03-22,2900,2910,2810,2830,2453.133789,1689400,100,-70,2850,2905.714286,3054.285714,107.8579312,2630
ISAT.JK,2019-03-25,2820,2820,2620,2630,2279.767578,3512700,200,-190,2855.714286,2880.714286,3017.142857,105.1755901,2560
ISAT.JK,2019-03-26,2700,2740,2550,2560,2219.089355,4318800,190,-140,2844.285714,2841.428571,2979.047619,125.9440541,2550
ISAT.JK,2019-03-27,2600,2630,2510,2550,2210.421143,2893000,120,-50,2818.571429,2806.428571,2939.047619,163.5469934,2580
ISAT.JK,2019-03-28,2580,2650,2550,2580,2236.426025,1186300,100,0,2767.142857,2770.714286,2910.47619,185.1768781,2510
ISAT.JK,2019-03-29,2560,2600,2500,2510,2175.747803,981900,100,-50,2705.714286,2752.857143,2878.571429,160.9199742,2390
ISAT.JK,2019-04-01,2500,2520,2370,2390,2071.728027,2608600,150,-110,2647.142857,2734.285714,2840.952381,143.6099214,2330
ISAT.JK,2019-04-02,2390,2470,2300,2330,2019.71814,3265000,170,-60,2578.571429,2714.285714,2796.666667,133.7196784,2330
ISAT.JK,2019-04-03,2330,2330,2330,2330,2019.71814,0,0,0,2507.142857,2681.428571,2756.190476,108.1225055,2410
ISAT.JK,2019-04-04,2330,2480,2330,2410,2089.064453,1850600,150,80,2464.285714,2654.285714,2715.714286,110.7334853,2620
ISAT.JK,2019-04-05,2450,2630,2450,2620,2271.099365,5340700,180,170,2442.857143,2630.714286,2685.238095,103.394759,2550
ISAT.JK,2019-04-08,2620,2650,2530,2550,2210.421143,2631400,120,-70,2452.857143,2610,2664.761905,117.8578644,2570
ISAT.JK,2019-04-09,2610,2620,2530,2570,2227.757813,3038700,90,-40,2448.571429,2577.142857,2651.428571,112.9053544,2580
ISAT.JK,2019-04-10,2600,2600,2550,2580,2236.426025,1100600,50,-20,2457.142857,2552.142857,2641.904762,120.3763938,2590
ISAT.JK,2019-04-11,2590,2650,2550,2590,2245.094238,1439100,100,0,2484.285714,2531.428571,2637.619048,124.0775487,2750
ISAT.JK,2019-04-12,2560,2770,2550,2750,2383.787354,9729000,220,190,2521.428571,2514.285714,2628.095238,108.0784547,2710
ISAT.JK,2019-04-15,2750,2790,2620,2710,2349.114014,4896700,170,-40,2581.428571,2522.857143,2630,100.403946,2710
ISAT.JK,2019-04-16,2710,2860,2700,2710,2349.114014,8631700,160,0,2624.285714,2533.571429,2628.571429,76.1264612,2710
ISAT.JK,2019-04-17,2710,2710,2710,2710,2349.114014,0,0,0,2637.142857,2545,2619.047619,82.60635281,2740
ISAT.JK,2019-04-18,2710,2760,2650,2740,2375.119141,3642000,110,30,2660,2554.285714,2604.761905,76.37626158,2740
ISAT.JK,2019-04-19,2740,2740,2740,2740,2375.119141,0,0,0,2684.285714,2570.714286,2596.190476,69.72736021,2700
ISAT.JK,2019-04-22,2740,2780,2670,2700,2340.445801,2571900,110,-40,2707.142857,2595.714286,2590,54.37961803,2620
ISAT.JK,2019-04-23,2690,2720,2610,2620,2271.099365,5943300,110,-70,2722.857143,2622.142857,2583.809524,19.7604704,2520
ISAT.JK,2019-04-24,2620,2660,2500,2520,2184.41626,4105100,160,-100,2704.285714,2642.857143,2583.333333,40.35556255,2480
ISAT.JK,2019-04-25,2520,2550,2450,2480,2149.742676,2183700,100,-40,2677.142857,2650.714286,2581.428571,80.14867138,2510
ISAT.JK,2019-04-26,2480,2590,2460,2510,2175.747803,4475700,130,30,2644.285714,2640.714286,2578.095238,107.0602856,2620
ISAT.JK,2019-04-29,2520,2670,2510,2620,2271.099365,6284200,160,100,2615.714286,2637.857143,2574.761905,113.1160382,2610
ISAT.JK,2019-04-30,2640,2660,2550,2610,2262.430908,8155600,110,-30,2598.571429,2641.428571,2580,99.40297974,2610
ISAT.JK,2019-05-01,2610,2610,2610,2610,2262.430908,0,0,0,2580,2643.571429,2590.47619,78.5281266,2510
ISAT.JK,2019-05-02,2610,2640,2500,2510,2175.747803,1926000,140,-100,2567.142857,2645,2603.809524,61.02302454,2450
ISAT.JK,2019-05-03,2510,2520,2400,2450,2123.738037,2645300,120,-60,2551.428571,2627.857143,2612.380952,59.2814112,2270
ISAT.JK,2019-05-06,2450,2450,2260,2270,1967.708252,5763600,190,-180,2541.428571,2609.285714,2614.285714,70.33931367,2220
ISAT.JK,2019-05-07,2280,2310,2200,2220,1924.366455,5835300,110,-60,2511.428571,2577.857143,2597.619048,124.690092,2150
ISAT.JK,2019-05-08,2220,2220,2100,2150,1863.688477,2674900,120,-70,2470,2542.857143,2581.904762,166.4331698,1985
ISAT.JK,2019-05-09,2160,2210,1985,1985,1720.661133,8209400,225,-175,2402.857143,2500.714286,2561.904762,189.0955919,2050
ISAT.JK,2019-05-10,1985,2070,1910,2050,1777.005249,8511700,160,65,2313.571429,2446.785714,2533.571429,220.0135277,1965
ISAT.JK,2019-05-13,2080,2090,1965,1965,1703.324463,3486800,125,-115,2233.571429,2400.357143,2507.857143,194.6088874,1915
ISAT.JK,2019-05-14,1950,1965,1895,1915,1659.98291,5860000,70,-35,2155.714286,2353.571429,2470.47619,173.4557718,1810
ISAT.JK,2019-05-15,1920,1925,1805,1810,1568.965454,3322700,120,-110,2079.285714,2310.357143,2432.619048,135.9971989,1710
ISAT.JK,2019-05-16,1810,1845,1700,1710,1482.282349,5177800,145,-100,2013.571429,2262.5,2389.761905,139.5741824,1715
ISAT.JK,2019-05-17,1710,1790,1700,1715,1486.616577,3696400,90,5,1940.714286,2205.357143,2342.142857,146.7829626,1765
ISAT.JK,2019-05-20,1715,1790,1680,1765,1529.95813,5652200,110,50,1878.571429,2140.714286,2293.333333,135.0220441,1800
ISAT.JK,2019-05-21,1765,1880,1765,1800,1560.297241,3359400,115,35,1847.142857,2080.357143,2246.904762,131.6832419,1800
ISAT.JK,2019-05-22,1800,1815,1760,1800,1560.297241,1640300,55,0,1811.428571,2022.5,2204.047619,96.7692395,1925
ISAT.JK,2019-05-23,1800,1930,1800,1925,1668.651245,6189200,130,125,1787.857143,1971.785714,2165,69.33356227,1895
ISAT.JK,2019-05-24,1925,2020,1890,1895,1642.64624,5236100,130,-30,1789.285714,1934.285714,2136.666667,72.42401601,2000
ISAT.JK,2019-05-27,1900,2020,1895,2000,1733.663574,11004000,125,100,1801.428571,1907.5,2108.809524,82.85098499,1975
ISAT.JK,2019-05-28,2000,2050,1970,1975,1711.992798,7819200,80,-25,1842.857143,1891.785714,2084.52381,100.2021766,1995
ISAT.JK,2019-05-29,1975,2020,1975,1995,1729.329346,2740900,45,20,1880,1879.285714,2053.809524,92.8260021,1995
ISAT.JK,2019-05-30,1995,1995,1995,1995,1729.329346,0,0,0,1912.857143,1880,2024.52381,85.77378887,2050
ISAT.JK,2019-05-31,1995,2100,1995,2050,1777.005249,11512300,105,55,1940.714286,1876.071429,1995.238095,73.84830011,2050
ISAT.JK,2019-06-03,2050,2050,2050,2050,1777.005249,0,0,0,1976.428571,1882.142857,1973.333333,51.53593291,2050
ISAT.JK,2019-06-04,2050,2050,2050,2050,1777.005249,0,0,0,1994.285714,1891.785714,1954.285714,52.39501976,2050
ISAT.JK,2019-06-05,2050,2050,2050,2050,1777.005249,0,0,0,2016.428571,1908.928571,1943.809524,32.36694375,2050
ISAT.JK,2019-06-06,2050,2050,2050,2050,1777.005249,0,0,0,2023.571429,1933.214286,1935.714286,33.62963546,2050
ISAT.JK,2019-06-07,2050,2050,2050,2050,1777.005249,0,0,0,2034.285714,1957.142857,1930.952381,26.83725201,2100
ISAT.JK,2019-06-10,2080,2170,2060,2100,1820.346802,6535700,110,20,2042.142857,1977.5,1934.047619,20.78804602,2100
ISAT.JK,2019-06-11,2110,2140,2080,2100,1820.346802,4080100,60,-10,2057.142857,1998.928571,1936.428571,18.89822365,2030
ISAT.JK,2019-06-12,2100,2130,2020,2030,1759.668457,4245400,110,-70,2064.285714,2020.357143,1942.857143,24.39750182,1945
ISAT.JK,2019-06-13,2030,2050,1945,1945,1685.987793,6463400,105,-85,2061.428571,2027.857143,1948.333333,27.34262328,1955
ISAT.JK,2019-06-14,1950,1975,1940,1955,1694.656128,2226100,35,5,2046.428571,2031.428571,1954.761905,52.17872217,1990
ISAT.JK,2019-06-17,1970,2020,1965,1990,1724.995361,2495700,55,20,2032.857143,2028.214286,1966.428571,62.44044782,1975
ISAT.JK,2019-06-18,1995,2010,1970,1975,1711.992798,1224200,40,-20,2024.285714,2029.285714,1979.52381,63.79841765,null
ISAT.JK,2019-06-19,null,null,null,null,null,null,#VALUE!,#VALUE!,2013.571429,2027.857143,1989.52381,65.04577143,2200
ISAT.JK,2019-06-20,2010,2220,1995,2200,1907.029907,17066200,225,190,1999.166667,2030.384615,1999,57.74224335,2370
ISAT.JK,2019-06-21,2250,2440,2230,2370,2054.391357,27318900,210,120,2015.833333,2041.923077,2019,95.04823337,2370
ISAT.JK,2019-06-24,2400,2420,2300,2370,2054.391357,11715200,120,-30,2072.5,2066.538462,2041.25,173.8605763,2350
ISAT.JK,2019-06-25,2410,2410,2340,2350,2037.054565,4624500,70,-60,2143.333333,2091.153846,2065,196.612987,2710
ISAT.JK,2019-06-26,2370,2720,2300,2710,2349.114014,28443400,420,340,2209.166667,2114.230769,2082.5,186.8265684,2580
ISAT.JK,2019-06-27,2710,2750,2580,2580,2236.426025,14810800,170,-130,2329.166667,2165,2119.25,241.2139438,2630
ISAT.JK,2019-06-28,2580,2690,2530,2630,2279.767578,10826600,160,50,2430,2205.769231,2148.5,182.9754082,2810
ISAT.JK,2019-07-01,2650,2820,2580,2810,2435.797363,26080900,240,160,2458.571429,2246.538462,2180.25,183.3419911,2730
ISAT.JK,2019-07-02,2830,2910,2720,2730,2366.450684,19041600,190,-100,2545.714286,2301.153846,2218.25,184.9195449,2580
ISAT.JK,2019-07-03,2730,2770,2550,2580,2236.426025,10547000,220,-150,2597.142857,2355,2252.25,177.8308453,2660
ISAT.JK,2019-07-04,2580,2730,2580,2660,2305.772461,12223700,150,80,2627.142857,2403.846154,2278.75,148.4042099,2710
ISAT.JK,2019-07-05,2670,2740,2620,2710,2349.114014,8320300,120,40,2671.428571,2458.076923,2309.25,84.34622525,2630
ISAT.JK,2019-07-08,2700,2720,2620,2630,2279.767578,3958400,100,-70,2671.428571,2513.461538,2342.25,84.34622525,2630
ISAT.JK,2019-07-09,2630,2720,2620,2630,2279.767578,4449300,100,0,2678.571429,2563.846154,2371.25,77.12080814,2830
ISAT.JK,2019-07-10,2640,2840,2640,2830,2453.133789,24307300,200,190,2678.571429,2568.571429,2397.75,77.12080814,2770
ISAT.JK,2019-07-11,2840,2970,2730,2770,2401.124023,29054400,240,-70,2681.428571,2613.571429,2434.25,82.9515062,2700
ISAT.JK,2019-07-12,2770,2810,2680,2700,2340.445801,8649300,130,-70,2687.142857,2642.142857,2471.25,88.07464367,2760
ISAT.JK,2019-07-15,2700,2780,2670,2760,2392.455811,5789700,110,60,2704.285714,2665.714286,2509,74.35436388,2890
ISAT.JK,2019-07-16,2760,2890,2760,2890,2505.143799,19537000,130,130,2718.571429,2695,2549.25,74.03345447,2820
ISAT.JK,2019-07-17,2900,2920,2810,2820,2444.46582,9813700,110,-80,2744.285714,2707.857143,2594.25,97.9552862,2760
ISAT.JK,2019-07-18,2820,2860,2750,2760,2392.455811,5332800,110,-60,2771.428571,2725,2636.5,86.68497975,2760
ISAT.JK,2019-07-19,2760,2810,2750,2760,2392.455811,4375700,60,0,2790,2734.285714,2642.380952,61.64414003,2790
ISAT.JK,2019-07-22,2750,2860,2710,2790,2418.460693,6993400,150,40,2780,2730.714286,2669.047619,59.72157622,2740
ISAT.JK,2019-07-23,2800,2840,2720,2740,2375.119141,5504200,120,-60,2782.857143,2735,2689.047619,59.64178784,2730
ISAT.JK,2019-07-24,2770,2820,2730,2730,2366.450684,6004000,90,-40,2788.571429,2746.428571,2706.666667,51.77791403,3040
ISAT.JK,2019-07-25,2770,3070,2770,3040,2635.168701,54471300,300,270,2784.285714,2751.428571,2724.761905,55.63486403,3140
ISAT.JK,2019-07-26,3040,3210,3020,3140,2721.851807,39478000,190,100,2805.714286,2775,2740.47619,107.6811873,3360
ISAT.JK,2019-07-29,3150,3390,3060,3360,2912.554932,27826300,330,210,2851.428571,2811.428571,2767.142857,166.5761659,3370
ISAT.JK,2019-07-30,3360,3450,3330,3370,2921.223145,17744600,120,10,2937.142857,2863.571429,2801.904762,246.7599566,3410
ISAT.JK,2019-07-31,3370,3450,3300,3410,2955.896484,19565700,150,40,3024.285714,2902.142857,2828.571429,279.3359473,3380
ISAT.JK,2019-08-01,3410,3420,3360,3380,2929.891357,6777600,60,-30,3112.857143,2947.857143,2860.952381,290.7297878,3260
ISAT.JK,2019-08-02,3380,3380,3150,3260,2825.871582,14477300,230,-120,3204.285714,2996.428571,2899.047619,251.9826147,3190
ISAT.JK,2019-08-05,3230,3340,3180,3190,2765.193604,7562700,160,-40,3280,3032.142857,2927.619048,140.8308678,3120
ISAT.JK,2019-08-06,3120,3240,3020,3120,2704.515137,15131500,220,0,3301.428571,3053.571429,2950.47619,105.1076546,3360
ISAT.JK,2019-08-07,3140,3400,3130,3360,2912.554932,16043500,270,220,3298.571429,3075,2973.809524,110.367352,3330
ISAT.JK,2019-08-08,3350,3440,3330,3330,2886.549805,12595500,110,-20,3298.571429,3117.857143,3008.571429,110.367352,3350
ISAT.JK,2019-08-09,3300,3390,3300,3350,2903.886475,4616200,90,50,3292.857143,3158.571429,3032.380952,107.038044,3600
ISAT.JK,2019-08-12,3360,3600,3320,3600,3120.594482,17077300,280,240,3284.285714,3198.571429,3060,98.12528435,3680
ISAT.JK,2019-08-13,3610,3730,3550,3680,3189.940918,21746500,180,70,3315.714286,3260,3102.857143,153.4988754,3740
ISAT.JK,2019-08-14,3700,3770,3650,3740,3241.950684,12311300,120,40,3375.714286,3327.857143,3146.666667,202.390476,3630
ISAT.JK,2019-08-15,3720,3730,3560,3630,3146.599365,5831800,170,-90,3454.285714,3377.857143,3187.142857,223.8941076,3650
ISAT.JK,2019-08-16,3630,3740,3630,3650,3163.936035,4281000,110,20,3527.142857,3412.857143,3225.714286,174.5197492,3830
ISAT.JK,2019-08-19,3680,3950,3680,3830,3319.96582,16822700,270,150,3568.571429,3433.571429,3268.095238,162.2167862,3600
ISAT.JK,2019-08-20,3850,3880,3600,3600,3120.594482,12121400,280,-250,3640,3466.428571,3319.047619,149.2201952,3660
ISAT.JK,2019-08-21,3600,3780,3600,3660,3172.604492,9400700,180,60,3675.714286,3480,3357.619048,83.83657572,3530
ISAT.JK,2019-08-22,3680,3730,3470,3530,3059.91626,7898900,260,-150,3684.285714,3500,3401.428571,77.64387567,3270
ISAT.JK,2019-08-23,3550,3580,3200,3270,2834.539795,10083600,380,-280,3662.857143,3519.285714,3439.52381,97.24784243,3410
ISAT.JK,2019-08-26,3270,3470,3060,3410,2955.896484,10928000,410,140,3595.714286,3525,3450.47619,170.0840129,3490
ISAT.JK,2019-08-27,3450,3560,3430,3490,3025.24292,6523700,130,40,3564.285714,3545.714286,3463.333333,182.5611444,3640
ISAT.JK,2019-08-28,3490,3650,3490,3640,3155.267578,6645700,160,150,3541.428571,3555,3469.52381,180.0396782,3690
ISAT.JK,2019-08-29,3660,3780,3650,3690,3198.609131,8804800,130,30,3514.285714,3577.142857,3482.380952,138.9073004,3650
ISAT.JK,2019-08-30,3690,3740,3650,3650,3163.936035,2523000,90,-40,3527.142857,3601.428571,3495.714286,151.7359863,3720
ISAT.JK,2019-09-02,3640,3740,3570,3720,3224.614258,5586200,170,80,3525.714286,3605,3508.571429,150.3171251,3490
ISAT.JK,2019-09-03,3730,3790,3430,3490,3025.24292,6242600,360,-240,3552.857143,3607.857143,3530.47619,167.4031347,3400
ISAT.JK,2019-09-04,3470,3620,3350,3400,2947.228027,4126100,270,-70,3584.285714,3590,3544.761905,119.1437707,3440
ISAT.JK,2019-09-05,3420,3490,3390,3440,2981.901367,5362400,100,20,3582.857143,3573.571429,3558.095238,121.6161017,3540
ISAT.JK,2019-09-06,3470,3640,3450,3540,3068.584473,6033400,190,70,3575.714286,3558.571429,3561.904762,129.2100542,3480
ISAT.JK,2019-09-09,3540,3610,3450,3480,3016.574707,2358500,160,-60,3561.428571,3537.857143,3571.904762,126.4157917,3500
ISAT.JK,2019-09-10,3500,3560,3490,3500,3033.911133,1915200,70,0,3531.428571,3529.285714,3578.095238,115.2430145,3470
ISAT.JK,2019-09-11,3500,3540,3450,3470,3007.90625,1539300,90,-30,3510,3517.857143,3573.333333,102.794293,3370
ISAT.JK,2019-09-12,3450,3500,3360,3370,2921.223145,2126200,140,-80,3474.285714,3513.571429,3563.333333,44.66808811,3330
ISAT.JK,2019-09-13,3370,3410,3310,3330,2886.549805,2628400,100,-40,3457.142857,3520.714286,3545.714286,58.51332775,3170
ISAT.JK,2019-09-16,3330,3330,3150,3170,2747.856689,3566300,180,-160,3447.142857,3515,3531.428571,73.87247699,3280
ISAT.JK,2019-09-17,3170,3320,3120,3280,2843.208252,4760300,200,110,3408.571429,3492.142857,3508.571429,128.5079208,3260
ISAT.JK,2019-09-18,3300,3370,3260,3260,2825.871582,3696800,110,-40,3371.428571,3466.428571,3482.380952,121.5769402,3210
ISAT.JK,2019-09-19,3330,3330,3200,3210,2782.530029,2652300,130,-120,3340,3435.714286,3466.190476,117.1893055,3210
ISAT.JK,2019-09-20,3220,3250,3160,3210,2782.530029,1411200,90,-10,3298.571429,3404.285714,3444.761905,101.3950313,3090
ISAT.JK,2019-09-23,3250,3250,3050,3090,2678.510254,2918000,200,-160,3261.428571,3367.857143,3429.52381,71.28079953,3010
ISAT.JK,2019-09-24,3090,3090,2970,3010,2609.163574,2052100,120,-80,3221.428571,3339.285714,3420.952381,78.40675384,2890
ISAT.JK,2019-09-25,3020,3020,2890,2890,2505.143799,3154800,130,-130,3175.714286,3311.428571,3401.904762,95.89180411,3040
ISAT.JK,2019-09-26,2920,3070,2890,3040,2635.168701,8185700,180,120,3135.714286,3272.142857,3373.333333,144.6671056,2980
ISAT.JK,2019-09-27,3070,3070,2930,2980,2583.158691,4033000,140,-90,3101.428571,3236.428571,3344.761905,132.718822,2850
ISAT.JK,2019-09-30,2980,2980,2850,2850,2470.470459,3356500,130,-130,3061.428571,3200.714286,3310.952381,118.3819484,2830
ISAT.JK,2019-10-01,2870,2920,2820,2830,2453.133789,2071500,100,-40,3010,3154.285714,3272.857143,121.2435565,2670
ISAT.JK,2019-10-02,2800,2850,2650,2670,2314.440918,3529100,200,-130,2955.714286,3108.571429,3230.47619,99.97618764,2700
ISAT.JK,2019-10-03,2670,2750,2610,2700,2340.445801,3314900,140,30,2895.714286,3058.571429,3191.428571,128.0438913,2810
ISAT.JK,2019-10-04,2720,2850,2690,2810,2435.797363,8936600,160,90,2851.428571,3013.571429,3158.095238,135.3302838,2730
ISAT.JK,2019-10-07,2830,2990,2720,2730,2366.450684,11519300,270,-100,2840,2987.857143,3128.095238,134.9073756,2720
ISAT.JK,2019-10-08,2730,2810,2630,2720,2357.782471,5208000,180,-10,2795.714286,2948.571429,3089.52381,106.1221219,2710
ISAT.JK,2019-10-09,2700,2770,2690,2710,2349.114014,2889000,80,10,2758.571429,2910,3053.333333,70.33931367,2670
ISAT.JK,2019-10-10,2700,2760,2660,2670,2314.440918,5006600,100,-30,2738.571429,2874.285714,3015.714286,58.99959645,2680
ISAT.JK,2019-10-11,2700,2720,2650,2680,2323.109131,2946200,70,-20,2715.714286,2835.714286,2977.619048,47.55948656,3040
ISAT.JK,2019-10-14,2700,3040,2700,3040,2635.168701,22480000,340,340,2717.142857,2806.428571,2944.761905,46.08480795,3260
ISAT.JK,2019-10-15,3100,3440,3050,3260,2825.871582,42727300,390,160,2765.714286,2808.571429,2930.952381,129.2100542,3310
ISAT.JK,2019-10-16,3260,3460,3260,3310,2869.213379,14107600,200,50,2830,2835,2935.238095,228.6190427,3180
ISAT.JK,2019-10-17,3320,3350,3140,3180,2756.525146,6541600,210,-140,2912.857143,2854.285714,2936.666667,284.5882573,3100
ISAT.JK,2019-10-18,3180,3200,3050,3100,2687.178467,7480000,150,-80,2978.571429,2868.571429,2932.857143,285.740475,3090
ISAT.JK,2019-10-21,3120,3170,3050,3090,2678.510254,3304200,120,-30,3034.285714,2886.428571,2927.619048,261.6522592,3390
ISAT.JK,2019-10-22,3100,3390,3100,3390,2938.559814,27646900,290,290,3094.285714,2905,2921.904762,206.5475847,3300
ISAT.JK,2019-10-23,3400,3450,3270,3300,2860.544922,13536000,180,-100,3195.714286,2956.428571,2936.190476,128.9518182,3320
ISAT.JK,2019-10-24,3370,3390,3280,3320,2877.881348,9211200,110,-50,3232.857143,2999.285714,2950,113.0949875,3150
ISAT.JK,2019-10-25,3330,3370,3100,3150,2730.52002,7268800,270,-180,3241.428571,3035.714286,2970.47619,117.6759068,3150
ISAT.JK,2019-10-28,3170,3270,3150,3150,2730.52002,5606100,120,-20,3218.571429,3065.714286,2975.714286,117.6759068,3140
ISAT.JK,2019-10-29,3160,3190,3120,3140,2721.851807,2943000,70,-20,3214.285714,3096.428571,2983.809524,119.8411647,3230
ISAT.JK,2019-10-30,3180,3330,3170,3230,2799.866699,11663100,160,50,3220,3127.142857,2997.619048,114.3095213,3320
ISAT.JK,2019-10-31,3230,3330,3190,3320,2877.881348,7560900,140,90,3240,3167.142857,3016.666667,98.99494937,3200
ISAT.JK,2019-11-01,3320,3340,3160,3200,2773.861572,4521600,180,-120,3230,3212.857143,3047.619048,83.66600265,3190
ISAT.JK,2019-11-04,3180,3260,3160,3190,2765.193604,4367800,100,10,3215.714286,3224.285714,3071.428571,78.07200584,3250
ISAT.JK,2019-11-05,3200,3280,3160,3250,2817.203369,6585900,120,50,3197.142857,3219.285714,3089.52381,63.17021601,3400
ISAT.JK,2019-11-06,3300,3410,3230,3400,2947.228027,24480000,180,100,3211.428571,3215,3114.285714,62.029179,3340
ISAT.JK,2019-11-07,3410,3480,3300,3340,2895.218262,20093800,180,-70,3247.142857,3230.714286,3146.666667,87.50510189,3500
ISAT.JK,2019-11-08,3420,3550,3360,3500,3033.911133,21137300,190,80,3275.714286,3247.857143,3176.666667,78.92129895,3410
ISAT.JK,2019-11-11,3500,3500,3370,3410,2955.896484,10312700,130,-90,3314.285714,3277.142857,3216.190476,111.9311013,3430
ISAT.JK,2019-11-12,3400,3480,3400,3430,2973.233154,4886900,80,30,3327.142857,3278.571429,3250.952381,117.7163661,3310
ISAT.JK,2019-11-13,3430,3460,3250,3310,2869.213379,8694900,210,-120,3360,3287.857143,3269.52381,108.012345,3310
ISAT.JK,2019-11-14,3310,3380,3250,3310,2869.213379,4802700,130,0,3377.142857,3287.142857,3271.904762,83.2094317,3120
ISAT.JK,2019-11-15,3320,3370,3100,3120,2704.515137,6996200,270,-200,3385.714286,3298.571429,3271.904762,69.96597813,3140
ISAT.JK,2019-11-18,3120,3210,3060,3140,2721.851807,5458600,150,20,3345.714286,3296.428571,3269.047619,121.4985793,3180
ISAT.JK,2019-11-19,3120,3230,3050,3180,2756.525146,4299100,180,60,3317.142857,3296.428571,3270.952381,144.4200224,3150
ISAT.JK,2019-11-20,3200,3270,3150,3150,2730.52002,4752300,120,-50,3271.428571,3292.857143,3275.238095,126.4157917,3050
ISAT.JK,2019-11-21,3160,3180,3000,3050,2643.836914,8520300,180,-110,3234.285714,3280.714286,3263.809524,116.7414726,3050
ISAT.JK,2019-11-22,3060,3100,3010,3050,2643.836914,3818800,90,-10,3180,3270,3251.904762,97.2967968,3120
ISAT.JK,2019-11-25,3060,3150,3050,3120,2704.515137,5012600,100,60,3142.857143,3260,3239.047619,88.64052604,3100
ISAT.JK,2019-11-26,3140,3150,3070,3100,2687.178467,21034700,80,-40,3115.714286,3250.714286,3237.619048,49.28053803,3030
ISAT.JK,2019-11-27,3100,3100,3020,3030,2626.500244,2565500,80,-70,3112.857143,3229.285714,3235.238095,49.56957592,2870
ISAT.JK,2019-11-28,3040,3060,2840,2870,2487.807373,4981700,220,-170,3097.142857,3207.142857,3230,56.48430039,2860
ISAT.JK,2019-11-29,2880,2930,2720,2860,2479.138916,4391500,210,-20,3052.857143,3162.142857,3212.857143,91.41741003,3010
ISAT.JK,2019-12-02,2880,3030,2880,3010,2609.163574,3256900,150,130,3011.428571,3122.857143,3190.952381,104.7900395,3000
ISAT.JK,2019-12-03,3020,3090,2960,3000,2600.495361,3182000,130,-20,3005.714286,3092.857143,3181.904762,103.4177842,2970
ISAT.JK,2019-12-04,2990,3020,2920,2970,2574.490479,1180700,100,-20,2998.571429,3070.714286,3172.857143,101.5592719,3130
ISAT.JK,2019-12-05,3000,3130,2980,3130,2713.18335,7405700,150,130,2977.142857,3046.428571,3159.52381,86.35475006,3090
ISAT.JK,2019-12-06,3140,3170,3040,3090,2678.510254,6430600,130,-50,2981.428571,3047.142857,3146.666667,93.88442743,3080
ISAT.JK,2019-12-09,3100,3130,3060,3080,2669.841797,3117300,70,-20,2990,3043.571429,3134.761905,101.4889157,3040
ISAT.JK,2019-12-10,3110,3150,3030,3040,2635.168701,3302100,120,-70,3020,3036.428571,3114.761905,90.55385138,3020
ISAT.JK,2019-12-11,3050,3090,3010,3020,2617.832031,2551400,80,-30,3045.714286,3028.571429,3097.142857,56.82051943,3030
ISAT.JK,2019-12-12,3040,3060,3020,3030,2626.500244,2324100,40,-10,3047.142857,3026.428571,3077.619048,55.89105048,3120
ISAT.JK,2019-12-13,3060,3170,3040,3120,2704.515137,7731500,130,60,3051.428571,3025,3064.285714,52.734736,3110
ISAT.JK,2019-12-16,3130,3200,3100,3110,2695.846924,4114100,100,-20,3072.857143,3025,3055.238095,43.8612531,3090
ISAT.JK,2019-12-17,3120,3140,3060,3090,2678.510254,2433900,80,-30,3070,3025.714286,3054.761905,40,3000
ISAT.JK,2019-12-18,3090,3090,2980,3000,2600.495361,6597000,110,-90,3070,3030,3052.380952,40,2960
ISAT.JK,2019-12-19,3010,3040,2920,2960,2565.822021,3514400,120,-50,3058.571429,3039.285714,3043.809524,47.40906082,2910
ISAT.JK,2019-12-20,2960,2990,2880,2910,2522.480469,4582700,110,-50,3047.142857,3046.428571,3034.761905,60.47431568,2910
ISAT.JK,2019-12-23,2920,2960,2910,2910,2522.480469,2862300,50,-10,3031.428571,3039.285714,3028.095238,79.88086367,2940
ISAT.JK,2019-12-26,2920,2950,2880,2940,2548.485596,1645600,70,20,3014.285714,3032.857143,3021.428571,92.1696159,2940
ISAT.JK,2019-12-27,2950,2960,2910,2940,2548.485596,1752000,50,-10,2988.571429,3030.714286,3012.857143,82.34653837,2910
ISAT.JK,2019-12-30,2960,2960,2910,2910,2522.480469,1374700,50,-50,2964.285714,3017.142857,3005.238095,63.47102826,2870
ISAT.JK,2020-01-02,2910,2930,2860,2870,2487.807373,1142700,70,-40,2938.571429,3004.285714,2999.52381,33.38091842,2890
ISAT.JK,2020-01-03,2870,2920,2870,2890,2505.143799,1172600,50,20,2920,2989.285714,2999.52381,29.43920289,2850
ISAT.JK,2020-01-06,2900,2910,2850,2850,2470.470459,2895300,60,-50,2910,2978.571429,3000.952381,25.16611478,2900
ISAT.JK,2020-01-07,2860,2940,2860,2900,2513.812012,3543300,80,40,2901.428571,2966.428571,2993.333333,33.8765265,2850
ISAT.JK,2020-01-08,2830,2880,2830,2850,2470.470459,1823500,50,20,2900,2957.142857,2988.571429,33.66501646,2870
ISAT.JK,2020-01-09,2850,2880,2830,2870,2487.807373,1322900,50,20,2887.142857,2937.857143,2982.857143,33.02235895,2890
ISAT.JK,2020-01-10,2880,2940,2880,2890,2505.143799,3364500,60,10,2877.142857,2920.714286,2970.47619,23.60387377,2930
ISAT.JK,2020-01-13,2890,2940,2890,2930,2539.817139,1810400,50,40,2874.285714,2906.428571,2960.952381,19.88059595,2880
ISAT.JK,2020-01-14,2940,2960,2880,2880,2496.475586,1780900,80,-60,2882.857143,2901.428571,2953.809524,28.70208222,2790
ISAT.JK,2020-01-15,2880,2910,2780,2790,2418.460693,3804200,130,-90,2881.428571,2895.714286,2946.190476,28.53569194,2730
ISAT.JK,2020-01-16,2790,2790,2720,2730,2366.450684,4654400,70,-60,2872.857143,2887.142857,2935.238095,44.23960733,2710
ISAT.JK,2020-01-17,2740,2790,2710,2710,2349.114014,3029000,80,-30,2848.571429,2874.285714,2920.952381,67.43603671,2650
ISAT.JK,2020-01-20,2730,2730,2630,2650,2297.104248,2924900,100,-80,2828.571429,2857.857143,2901.428571,85.32849689,2550
ISAT.JK,2020-01-21,2650,2670,2550,2550,2210.421143,4912200,120,-100,2797.142857,2837.142857,2879.52381,105.6273774,2370
ISAT.JK,2020-01-22,2530,2590,2370,2370,2054.391357,7571700,220,-160,2748.571429,2811.428571,2853.809524,130.9489177,2390
ISAT.JK,2020-01-23,2370,2440,2270,2390,2071.728027,7053900,170,20,2668.571429,2775.714286,2823.809524,167.5737222,2340
ISAT.JK,2020-01-24,2410,2420,2330,2340,2028.38623,2596700,90,-70,2598.571429,2740,2796.666667,166.8760589,2230
ISAT.JK,2020-01-27,2320,2350,2230,2230,1933.03479,3414100,120,-90,2534.285714,2703.571429,2769.52381,167.516879,2270
ISAT.JK,2020-01-28,2220,2310,2150,2270,1967.708252,5598400,160,50,2462.857143,2655.714286,2737.142857,176.5138602,2330
ISAT.JK,2020-01-29,2300,2380,2260,2330,2019.71814,5709200,120,30,2400,2614.285714,2705.238095,150.2220579,2290
ISAT.JK,2020-01-30,2340,2360,2250,2290,1985.044678,2886800,110,-50,2354.285714,2575.714286,2676.190476,102.6088272,2290
ISAT.JK,2020-01-31,2300,2300,2200,2290,1985.044678,3757900,100,-10,2317.142857,2532.857143,2646.666667,56.77860093,2170
ISAT.JK,2020-02-03,2280,2280,2170,2170,1881.024902,2417700,110,-110,2305.714286,2487.142857,2619.047619,52.23572943,2190
ISAT.JK,2020-02-04,2200,2250,2120,2190,1898.361572,5616400,130,-10,2274.285714,2436.428571,2584.761905,58.83795341,2400
ISAT.JK,2020-02-05,2210,2460,2200,2400,2080.396484,21444000,260,190,2252.857143,2393.571429,2553.333333,58.22779569,2370
ISAT.JK,2020-02-06,2440,2450,2320,2370,2054.391357,13917300,130,-70,2277.142857,2370,2529.52381,78.89112449,2370
ISAT.JK,2020-02-07,2370,2430,2340,2370,2054.391357,5197500,90,0,2291.428571,2345.714286,2506.666667,86.10624666,2260
ISAT.JK,2020-02-10,2360,2390,2240,2260,1959.039917,5167300,150,-100,2297.142857,2325.714286,2482.857143,90.31690239,2190
ISAT.JK,2020-02-11,2250,2310,2180,2190,1898.361572,8107600,130,-60,2292.857143,2305,2452.857143,91.41741003,2170
ISAT.JK,2020-02-12,2210,2250,2160,2170,1881.024902,4324000,90,-40,2278.571429,2292.142857,2417.619048,99.40297974,1980
ISAT.JK,2020-02-13,2170,2200,1955,1980,1716.326904,16261000,245,-190,2278.571429,2276.428571,2383.809524,99.40297974,2100
ISAT.JK,2020-02-14,1985,2130,1980,2100,1820.346802,14788000,150,115,2248.571429,2250.714286,2345.238095,149.6026483,2050
ISAT.JK,2020-02-17,2040,2080,1985,2050,1777.005249,8036600,95,10,2205.714286,2241.428571,2315.238095,141.7576738,2170
ISAT.JK,2020-02-18,2050,2170,2040,2170,1881.024902,9847700,130,120,2160,2225.714286,2283.809524,131.1487705,2300
ISAT.JK,2020-02-19,2180,2320,2170,2300,1993.713013,8482900,150,120,2131.428571,2214.285714,2260.952381,94.4154951,2300
ISAT.JK,2020-02-20,2300,2350,2240,2300,1993.713013,4292700,110,0,2137.142857,2215,2249.047619,104.1976145,2200
ISAT.JK,2020-02-21,2300,2300,2190,2200,1907.029907,4012100,110,-100,2152.857143,2215.714286,2245.714286,120.5147689,2170
ISAT.JK,2020-02-24,2200,2280,2160,2170,1881.024902,3504400,120,-30,2157.142857,2217.857143,2236.666667,121.7530678,2230
ISAT.JK,2020-02-25,2160,2240,2100,2230,1933.03479,3533200,140,70,2184.285714,2216.428571,2228.571429,93.60504667,2150
ISAT.JK,2020-02-26,2220,2220,2140,2150,1863.688477,3499600,80,-70,2202.857143,2204.285714,2228.571429,86.7398958,2050
ISAT.JK,2020-02-27,2140,2180,2000,2050,1777.005249,3752100,180,-90,2217.142857,2188.571429,2222.857143,62.10590034,2040
ISAT.JK,2020-02-28,1995,2040,1875,2040,1768.336914,9568600,165,45,2200,2165.714286,2209.52381,88.31760866,2090
ISAT.JK,2020-03-02,2040,2130,2010,2090,1811.678345,4795800,120,50,2162.857143,2150,2197.619048,93.75753938,2160
ISAT.JK,2020-03-03,2100,2180,2100,2160,1872.356567,3589000,80,60,2132.857143,2142.857143,2188.095238,74.09774754,2260
ISAT.JK,2020-03-04,2150,2280,2120,2260,1959.039917,5744600,160,110,2127.142857,2142.142857,2187.619048,69.45365018,2240
ISAT.JK,2020-03-05,2260,2320,2210,2240,1941.703125,3194900,110,-20,2140,2162.142857,2190.952381,85.24474568,2160
ISAT.JK,2020-03-06,2210,2230,2140,2160,1872.356567,3026800,90,-50,2141.428571,2172.142857,2183.333333,87.06866475,2000
ISAT.JK,2020-03-09,2100,2140,1990,2000,1733.663574,2842800,150,-100,2142.857143,2180,2173.333333,87.31442907,2060
ISAT.JK,2020-03-10,2000,2100,2000,2060,1785.673462,3008300,100,60,2135.714286,2167.857143,2155.714286,97.61440175,1895
ISAT.JK,2020-03-11,2080,2130,1860,1895,1642.64624,3550100,270,-185,2138.571429,2150.714286,2146.190476,94.59185508,1715
ISAT.JK,2020-03-12,1895,1895,1710,1715,1486.616577,5089100,185,-180,2110.714286,2121.785714,2132.142857,132.426979,1715
ISAT.JK,2020-03-13,1715,1715,1715,1715,1486.616577,0,0,0,2047.142857,2087.142857,2110.47619,196.2536017,1580
ISAT.JK,2020-03-16,1685,1685,1580,1580,1369.594238,2183100,105,-105,1969.285714,2054.642857,2097.857143,205.6175368,1470
ISAT.JK,2020-03-17,1570,1580,1470,1470,1274.242798,1092500,110,-100,1875,2008.214286,2073.095238,212.0141505,1370
ISAT.JK,2020-03-18,1480,1500,1370,1370,1187.55957,5371400,130,-110,1776.428571,1959.642857,2045.47619,217.7482163,1275
ISAT.JK,2020-03-19,1370,1370,1275,1275,1105.210571,218200,95,-95,1686.428571,1911.071429,2007.380952,239.0905387,1375
ISAT.JK,2020-03-20,1260,1375,1190,1375,1191.893677,7907400,185,115,1574.285714,1856.428571,1958.571429,217.8192785,1280
ISAT.JK,2020-03-23,1330,1330,1280,1280,1109.544678,590100,50,-50,1500,1805.357143,1914.52381,174.5947689,1200
ISAT.JK,2020-03-24,1270,1345,1195,1200,1040.198242,4575000,150,-70,1437.857143,1742.5,1870.714286,162.2974929,1340
ISAT.JK,2020-03-26,1220,1450,1220,1340,1161.554565,10928200,230,120,1364.285714,1666.785714,1824.52381,129.0487173,1400
ISAT.JK,2020-03-27,1400,1570,1345,1400,1213.564453,13601000,225,0,1330,1602.5,1782.142857,87.32124598,1425
ISAT.JK,2020-03-30,1370,1425,1305,1425,1235.235229,2475300,120,55,1320,1548.214286,1746.428571,71.12196098,1555
ISAT.JK,2020-03-31,1450,1600,1450,1555,1347.923462,4980100,150,105,1327.857143,1507.142857,1716.666667,80.04463041,1550
ISAT.JK,2020-04-01,1560,1640,1515,1550,1343.589233,4599100,125,-10,1367.857143,1471.071429,1693.571429,112.5780153,1735
ISAT.JK,2020-04-02,1545,1750,1490,1735,1503.953125,6129100,260,190,1392.857143,1446.428571,1667.857143,132.1570134,1945
ISAT.JK,2020-04-03,1770,2010,1750,1945,1685.987793,9056200,260,175,1457.857143,1447.857143,1647.619048,172.984998,2180
ISAT.JK,2020-04-06,1985,2180,1985,2180,1889.693237,6411600,195,195,1564.285714,1464.285714,1632.619048,212.5525145,2060
ISAT.JK,2020-04-07,2220,2370,2030,2060,1785.673462,13099600,340,-160,1684.285714,1507.142857,1629.761905,288.4069545,1920
ISAT.JK,2020-04-08,2040,2060,1920,1920,1664.317017,6789400,140,-120,1778.571429,1549.285714,1625,287.8615739,1955
ISAT.JK,2020-04-09,1950,2030,1900,1955,1694.656128,5157300,130,5,1849.285714,1588.571429,1621.190476,243.984777,1990
ISAT.JK,2020-04-13,1995,2030,1860,1990,1724.995361,3213600,170,-5,1906.428571,1637.142857,1616.190476,207.7200497,2070
ISAT.JK,2020-04-14,2000,2080,1970,2070,1794.341797,7220800,110,70,1969.285714,1681.071429,1620.714286,136.1196952,1985
ISAT.JK,2020-04-15,2090,2130,1970,1985,1720.661133,6761700,160,-105,2017.142857,1737.5,1637.619048,91.64501909,1880
ISAT.JK,2020-04-16,1985,1985,1850,1880,1629.643799,6285900,135,-105,2022.857143,1793.571429,1650.47619,87.55270522,2040
ISAT.JK,2020-04-17,1880,2050,1880,2040,1768.336914,7229200,170,160,1980,1832.142857,1664.761905,69.34214688,1965
ISAT.JK,2020-04-20,2060,2080,1955,1965,1703.324463,6599000,125,-95,1977.142857,1877.857143,1691.904762,65.81901592,1905
ISAT.JK,2020-04-21,1965,1975,1900,1905,1651.314453,2800300,75,-60,1983.571429,1916.428571,1720.238095,61.35377506,2110
ISAT.JK,2020-04-22,1900,2180,1880,2110,1829.015137,15745000,300,210,1976.428571,1941.428571,1750.238095,67.80574495,2030
ISAT.JK,2020-04-23,2150,2160,2030,2030,1759.668457,10184200,130,-120,1993.571429,1981.428571,1785.238095,84.83878269,2000
ISAT.JK,2020-04-24,2020,2150,1990,2000,1733.663574,7758500,160,-20,1987.857143,2002.5,1820.952381,80.04463041,2070
ISAT.JK,2020-04-27,2040,2100,2030,2070,1794.341797,3081400,70,30,1990,2006.428571,1859.047619,80.15609771,2040
ISAT.JK,2020-04-28,2080,2100,2030,2040,1768.336914,5225200,70,-40,2017.142857,1998.571429,1893.809524,67.93729602,2250
ISAT.JK,2020-04-29,2050,2280,2050,2250,1950.37146,21169600,230,200,2017.142857,1997.142857,1924.285714,67.93729602,2150
ISAT.JK,2020-04-30,2240,2320,2150,2150,1863.688477,20021800,170,-90,2057.857143,2020.714286,1963.571429,106.1389476,2150
ISAT.JK,2020-05-04,2150,2180,2090,2150,1863.688477,5320300,90,0,2092.857143,2034.642857,1991.904762,85.77378887,2150
ISAT.JK,2020-05-05,2160,2210,2120,2150,1863.688477,6245000,90,-10,2098.571429,2046.071429,2020.47619,88.3984486,2100
ISAT.JK,2020-05-06,2170,2180,2090,2100,1820.346802,3876200,90,-70,2115.714286,2051.785714,2040.238095,84.43086775,2050
ISAT.JK,2020-05-08,2120,2140,2040,2050,1777.005249,7858100,100,-70,2130,2060,2047.619048,68.556546,2110
ISAT.JK,2020-05-11,2070,2150,2060,2110,1829.015137,12567000,90,40,2127.142857,2072.142857,2041.428571,71.81324987,2000
ISAT.JK,2020-05-12,2110,2130,1990,2000,1733.663574,10833400,140,-110,2137.142857,2077.142857,2043.809524,61.83695921,1995
ISAT.JK,2020-05-13,2010,2040,1950,1995,1729.329346,5515600,90,-15,2101.428571,2079.642857,2047.619048,57.85861256,1950
ISAT.JK,2020-05-14,1995,2030,1925,1950,1690.322021,4149200,105,-45,2079.285714,2086.071429,2049.52381,65.34705881,2020
ISAT.JK,2020-05-15,1980,2020,1945,2020,1751.000244,5497600,75,40,2050.714286,2074.642857,2047.619048,72.59640553,2030
ISAT.JK,2020-05-18,2040,2080,2010,2030,1759.668457,9332400,70,-10,2032.142857,2073.928571,2045.238095,58.15619363,2000
ISAT.JK,2020-05-19,2060,2090,2000,2000,1733.663574,5322900,90,-60,2022.142857,2076.071429,2047.380952,49.98809382,1975
ISAT.JK,2020-05-20,2000,2030,1975,1975,1711.992798,2048000,55,-25,2015,2071.071429,2053.095238,48.90466917,2110
ISAT.JK,2020-05-26,1990,2120,1980,2110,1829.015137,8717400,140,120,1995.714286,2066.428571,2050,26.83725201,2110
ISAT.JK,2020-05-27,2130,2150,2100,2110,1829.015137,6069100,50,-20,2011.428571,2056.428571,2056.904762,51.04852966,2050
ISAT.JK,2020-05-28,2110,2130,2030,2050,1777.005249,6519300,100,-60,2027.857143,2053.571429,2066.666667,62.17295385,2020
ISAT.JK,2020-05-29,2100,2110,2010,2020,1751.000244,4670700,100,-80,2042.142857,2046.428571,2063.809524,51.9500676,2070
ISAT.JK,2020-06-02,2020,2090,2020,2070,1794.341797,6158500,70,50,2042.142857,2037.142857,2063.333333,51.9500676,2060
ISAT.JK,2020-06-03,2100,2140,2060,2060,1785.673462,9120000,80,-40,2047.857143,2035,2066.666667,52.58779507,2090
ISAT.JK,2020-06-04,2080,2120,2040,2090,1811.678345,7712800,80,10,2056.428571,2035.714286,2066.190476,48.19355815,2240
ISAT.JK,2020-06-05,2060,2260,2060,2240,1941.703125,21503800,200,180,2072.857143,2034.285714,2068.571429,33.02235895,2210
ISAT.JK,2020-06-08,2300,2300,2210,2210,1915.698364,16864700,90,-90,2091.428571,2051.428571,2068.095238,71.51423435,2140
ISAT.JK,2020-06-09,2230,2260,2140,2140,1855.02002,7077100,120,-90,2105.714286,2066.785714,2070.952381,84.62803768,2230
ISAT.JK,2020-06-10,2140,2290,2130,2230,1933.03479,23502400,160,90,2118.571429,2080.357143,2070.47619,81.53293229,2230
ISAT.JK,2020-06-11,2240,2310,2180,2230,1933.03479,31719200,130,-10,2148.571429,2095.357143,2074.285714,77.76643908,2260
ISAT.JK,2020-06-12,2180,2260,2080,2260,1959.039917,13594600,180,80,2171.428571,2109.642857,2080.47619,74.25823668,2250
ISAT.JK,2020-06-15,2280,2450,2250,2250,1950.37146,46949400,200,-30,2200,2128.214286,2090.47619,61.64414003,2380
ISAT.JK,2020-06-16,2350,2390,2300,2380,2063.05957,23314400,90,30,2222.857143,2147.857143,2097.142857,39.8807747,2350
ISAT.JK,2020-06-17,2390,2420,2330,2350,2037.054565,12781300,90,-40,2242.857143,2167.142857,2115.238095,72.04495951,2500
ISAT.JK,2020-06-18,2300,2530,2290,2500,2167.07959,23787500,240,200,2262.857143,2184.285714,2132.142857,80.3563492,2530
ISAT.JK,2020-06-19,2500,2550,2470,2530,2193.084229,10242400,80,30,2314.285714,2216.428571,2158.333333,101.1364001,2500
ISAT.JK,2020-06-22,2530,2550,2430,2500,2167.07959,7013700,120,-30,2357.142857,2252.857143,2182.619048,121.0666876,2400
ISAT.JK,2020-06-23,2450,2510,2390,2400,2080.396484,5954500,120,-50,2395.714286,2283.571429,2205,116.7414726,2380
ISAT.JK,2020-06-24,2400,2440,2340,2380,2063.05957,4235400,100,-20,2415.714286,2307.857143,2224.047619,100.4750621,2320
ISAT.JK,2020-06-25,2380,2380,2320,2320,2011.049805,3131200,60,-60,2434.285714,2328.571429,2243.333333,72.99706452,2440
ISAT.JK,2020-06-26,2350,2450,2320,2440,2115.06958,5906400,130,90,2425.714286,2334.285714,2253.333333,83.23804075,2380
ISAT.JK,2020-06-29,2430,2430,2360,2380,2063.05957,3465300,70,-50,2438.571429,2350.714286,2269.047619,76.25146369,2350
ISAT.JK,2020-06-30,2360,2430,2340,2350,2037.054565,4174600,90,-10,2421.428571,2367.857143,2284.761905,73.58183006,2320
ISAT.JK,2020-07-01,2350,2380,2320,2320,2011.049805,2111000,60,-30,2395.714286,2376.428571,2300.47619,59.40177968,2320
ISAT.JK,2020-07-02,2320,2380,2300,2320,2011.049805,2947900,80,0,2370,2382.857143,2312.380952,43.58898944,2400
ISAT.JK,2020-07-03,2350,2480,2330,2400,2080.396484,8597500,150,50,2358.571429,2387.142857,2324.761905,44.88079449,2500
ISAT.JK,2020-07-06,2400,2540,2400,2500,2167.07959,12488800,140,100,2361.428571,2397.857143,2339.52381,47.05619741,2560
ISAT.JK,2020-07-07,2530,2630,2470,2560,2219.089355,11746900,160,30,2387.142857,2406.428571,2351.904762,66.00865744,2570
ISAT.JK,2020-07-08,2570,2600,2540,2570,2227.757813,6499900,60,0,2404.285714,2421.428571,2368.571429,92.35026491,2570
ISAT.JK,2020-07-09,2590,2640,2550,2570,2227.757813,5892200,90,-20,2431.428571,2426.428571,2389.047619,110.2162377,2560
ISAT.JK,2020-07-10,2550,2590,2530,2560,2219.089355,2630100,60,10,2462.857143,2429.285714,2405.238095,114.4136189,2570
ISAT.JK,2020-07-13,2570,2630,2560,2570,2227.757813,3272200,70,0,2497.142857,2433.571429,2420.952381,99.45087325,2550
ISAT.JK,2020-07-14,2570,2640,2550,2550,2210.421143,4022300,90,-20,2532.857143,2445.714286,2435.714286,63.69570517,2550
ISAT.JK,2020-07-15,2580,2600,2550,2550,2210.421143,2178000,50,-30,2554.285714,2457.857143,2450,25.07132682,2520
ISAT.JK,2020-07-16,2590,2590,2500,2520,2184.41626,2832000,90,-70,2561.428571,2474.285714,2458.095238,8.997354108,2560
ISAT.JK,2020-07-17,2530,2560,2530,2560,2219.089355,1924000,30,30,2555.714286,2480,2466.190476,18.12653934,2570
ISAT.JK,2020-07-20,2570,2580,2480,2570,2227.757813,5499800,100,0,2554.285714,2492.857143,2469.047619,17.18249386,2560
ISAT.JK,2020-07-21,2550,2600,2550,2560,2219.089355,4012900,50,10,2554.285714,2508.571429,2470.952381,17.18249386,2550
ISAT.JK,2020-07-22,2560,2580,2530,2550,2210.421143,2691500,50,-10,2554.285714,2525.714286,2473.809524,17.18249386,2540
ISAT.JK,2020-07-23,2570,2570,2540,2540,2201.752686,1250800,30,-30,2551.428571,2542.142857,2480.952381,15.73591585,2510
ISAT.JK,2020-07-24,2520,2590,2500,2510,2175.747803,1635300,90,-10,2550,2552.142857,2488.571429,16.32993162,2560
ISAT.JK,2020-07-27,2520,2590,2510,2560,2219.089355,2569600,80,40,2544.285714,2552.857143,2497.619048,22.25394561,2510
ISAT.JK,2020-07-28,2540,2590,2500,2510,2175.747803,2570600,90,-30,2550,2552.857143,2503.333333,20,2340
ISAT.JK,2020-07-29,2510,2540,2340,2340,2028.38623,14882100,200,-170,2542.857143,2548.571429,2509.52381,24.29971585,2300
ISAT.JK,2020-07-30,2350,2420,2210,2300,1993.713013,12918400,210,-50,2510,2532.142857,2509.047619,77.88880964,2170
ISAT.JK,2020-08-03,2320,2330,2140,2170,1881.024902,8778700,190,-150,2472.857143,2513.571429,2508.095238,106.7261739,2320
ISAT.JK,2020-08-04,2170,2330,2170,2320,2011.049805,5098900,160,150,2418.571429,2485,2500.952381,149.1563577,2360
ISAT.JK,2020-08-05,2340,2370,2270,2360,2045.723022,4611700,100,20,2387.142857,2468.571429,2497.142857,142.3275899,2400
ISAT.JK,2020-08-06,2350,2440,2350,2400,2080.396484,6064100,90,50,2365.714286,2455,2490.47619,131.6380318,2390
ISAT.JK,2020-08-07,2400,2430,2330,2390,2071.728027,3955800,100,-10,2342.857143,2446.428571,2482.857143,103.0718658,2390
ISAT.JK,2020-08-10,2430,2430,2390,2390,2071.728027,2045300,40,-40,2325.714286,2434.285714,2474.285714,77.42892286,2410
ISAT.JK,2020-08-11,2400,2430,2380,2410,2089.064453,2564900,50,10,2332.857143,2421.428571,2465.714286,81.18174789,2390
ISAT.JK,2020-08-12,2410,2440,2340,2390,2071.728027,2976300,100,-20,2348.571429,2410.714286,2458.571429,84.34622525,2510
ISAT.JK,2020-08-13,2390,2530,2390,2510,2175.747803,12907200,140,120,2380,2399.285714,2450,30.55050463,2540
ISAT.JK,2020-08-14,2520,2570,2460,2540,2201.752686,8406900,110,20,2407.142857,2397.142857,2448.095238,47.85891965,2490
ISAT.JK,2020-08-18,2530,2570,2490,2490,2158.411133,6776700,80,-40,2432.857143,2399.285714,2447.619048,63.95683068,2490
ISAT.JK,2020-08-19,2530,2530,2460,2490,2158.411133,4034700,70,-40,2445.714286,2394.285714,2446.190476,65.28326556,2460
ISAT.JK,2020-08-24,2500,2510,2430,2460,2132.40625,2377900,80,-40,2460,2392.857143,2442.857143,61.91391874,2470
ISAT.JK,2020-08-25,2490,2510,2460,2470,2141.074463,3045000,50,-20,2470,2401.428571,2437.619048,53.85164807,2500
ISAT.JK,2020-08-26,2470,2540,2440,2500,2167.07959,8676200,100,30,2478.571429,2413.571429,2433.333333,47.05619741,2430
ISAT.JK,2020-08-27,2510,2540,2390,2430,2106.401123,11288200,150,-80,2494.285714,2437.142857,2430.952381,26.367368,2380
ISAT.JK,2020-08-28,2430,2440,2360,2380,2063.05957,3843200,80,-50,2482.857143,2445,2425.714286,34.50327797,2300
ISAT.JK,2020-08-31,2400,2420,2250,2300,1993.713013,7804200,170,-100,2460,2446.428571,2419.52381,42.42640687,2300
ISAT.JK,2020-09-01,2300,2350,2290,2300,1993.713013,2652800,60,0,2432.857143,2439.285714,2407.142857,71.11359123,2330
ISAT.JK,2020-09-02,2310,2340,2300,2330,2019.71814,4515700,40,20,2405.714286,2432.857143,2397.142857,81.21107126,2360
ISAT.JK,2020-09-03,2350,2420,2340,2360,2045.723022,6971500,80,10,2387.142857,2428.571429,2396.666667,81.59131606,2310
ISAT.JK,2020-09-04,2330,2360,2300,2310,2002.38147,3701500,60,-20,2371.428571,2425,2399.52381,73.12741652,2290
ISAT.JK,2020-09-07,2320,2320,2260,2290,1985.044678,2098200,60,-30,2344.285714,2419.285714,2406.190476,48.5994317,2260
ISAT.JK,2020-09-08,2300,2310,2250,2260,1959.039917,2616500,60,-40,2324.285714,2403.571429,2404.761905,34.08672413,2220
ISAT.JK,2020-09-09,2250,2290,2200,2220,1924.366455,2723500,90,-30,2307.142857,2383.571429,2400,31.4718317,2080
ISAT.JK,2020-09-10,2220,2220,2080,2080,1803.010132,5892300,140,-140,2295.714286,2364.285714,2391.428571,45.77377082,2250
ISAT.JK,2020-09-11,2080,2280,1950,2250,1950.37146,3827500,330,170,2264.285714,2335,2376.666667,93.24826055,2260
ISAT.JK,2020-09-14,2260,2350,2250,2260,1959.039917,5787700,100,0,2252.857143,2320,2370,88.64052604,2170
ISAT.JK,2020-09-15,2260,2290,2160,2170,1881.024902,2937600,130,-90,2238.571429,2305,2362.857143,75.5928946,2170
ISAT.JK,2020-09-16,2170,2220,2160,2170,1881.024902,1344100,60,0,2218.571429,2281.428571,2352.380952,71.97883287,2130
ISAT.JK,2020-09-17,2170,2200,2110,2130,1846.351685,1552500,90,-40,2201.428571,2262.857143,2336.190476,66.18876325,2150
ISAT.JK,2020-09-18,2120,2190,2120,2150,1863.688477,1460700,70,30,2182.857143,2245,2316.666667,65.24678427,2030
ISAT.JK,2020-09-21,2160,2170,2020,2030,1759.668457,3178800,150,-130,2172.857143,2234.285714,2300.47619,63.95683068,2000
ISAT.JK,2020-09-22,2030,2070,1965,2000,1733.663574,4609900,105,-30,2165.714286,2215,2278.571429,77.42892286,1955
ISAT.JK,2020-09-23,2000,2050,1945,1955,1694.656128,4831900,105,-45,2130,2191.428571,2256.666667,88.88194417,1930
ISAT.JK,2020-09-24,1955,1955,1870,1930,1672.985229,5155800,85,-25,2086.428571,2162.5,2232.142857,89.28952373,1945
ISAT.JK,2020-09-25,1950,1980,1915,1945,1685.987793,3515900,65,-5,2052.142857,2135.357143,2205,97.54730232,2040
ISAT.JK,2020-09-28,1965,2040,1950,2040,1768.336914,4955400,90,75,2020,2110.714286,2181.904762,88.92881048,2020
ISAT.JK,2020-09-29,2060,2070,1990,2020,1751.000244,4591800,80,-40,2007.142857,2095,2165.714286,75.93073285,1990
ISAT.JK,2020-09-30,2030,2030,1955,1990,1724.995361,2763500,75,-40,1988.571429,2080.714286,2152.380952,44.60140933,2070
ISAT.JK,2020-10-01,1990,2140,1990,2070,1794.341797,6981400,150,80,1982.857143,2074.285714,2137.619048,40.81024615,2000
ISAT.JK,2020-10-02,2070,2070,1985,2000,1733.663574,2976600,85,-70,1992.857143,2061.428571,2125.238095,52.58779507,2020
ISAT.JK,2020-10-05,2030,2040,2000,2020,1751.000244,1033000,40,-10,1999.285714,2042.857143,2108.095238,49.86887568,2040
ISAT.JK,2020-10-06,2100,2110,2040,2040,1768.336914,4948000,70,-60,2012.142857,2032.142857,2094.285714,39.56609901,2080
ISAT.JK,2020-10-07,2040,2130,2020,2080,1803.010132,7003400,110,40,2025.714286,2022.857143,2082.380952,26.99206233,2070
ISAT.JK,2020-10-08,2080,2120,2060,2070,1794.341797,2707700,60,-10,2031.428571,2019.285714,2073.809524,33.8765265,2070
ISAT.JK,2020-10-09,2070,2100,2060,2070,1794.341797,1309100,40,0,2038.571429,2013.571429,2066.666667,36.25307869,2060
ISAT.JK,2020-10-12,2080,2110,2050,2060,1785.673462,2158000,60,-20,2050,2016.428571,2066.190476,30.55050463,2060
ISAT.JK,2020-10-13,2060,2100,2030,2060,1785.673462,5637900,70,0,2048.571429,2020.714286,2057.142857,29.68084199,2090
ISAT.JK,2020-10-14,2060,2120,2050,2090,1811.678345,8956600,70,30,2057.142857,2028.214286,2047.619048,20.58663459,2040
ISAT.JK,2020-10-15,2070,2100,2030,2040,1768.336914,4049600,70,-30,2067.142857,2039.642857,2043.809524,16.03567451,2050
ISAT.JK,2020-10-16,2040,2080,2030,2050,1777.005249,3887500,50,10,2067.142857,2046.428571,2037.619048,16.03567451,2070
ISAT.JK,2020-10-19,2070,2080,2040,2070,1794.341797,3706400,40,0,2062.857143,2047.142857,2033.809524,16.03567451,2040
ISAT.JK,2020-10-20,2070,2070,2020,2040,1768.336914,1771100,50,-30,2062.857143,2050.714286,2030,16.03567451,2050
ISAT.JK,2020-10-21,2050,2080,2030,2050,1777.005249,1762500,50,0,2058.571429,2054.285714,2030.47619,17.72810521,2040
ISAT.JK,2020-10-22,2050,2060,2020,2040,1768.336914,858900,40,-10,2057.142857,2052.857143,2032.857143,17.99470822,2050
ISAT.JK,2020-10-23,2040,2070,2030,2050,1777.005249,971200,40,10,2054.285714,2055.714286,2036.904762,19.02379462,2020
ISAT.JK,2020-10-26,2050,2070,2000,2020,1751.000244,7546700,70,-30,2048.571429,2057.857143,2042.619048,10.69044968,2010
ISAT.JK,2020-10-27,2020,2040,2000,2010,1742.331909,1822600,40,-10,2045.714286,2056.428571,2046.190476,15.11857892,2010
ISAT.JK,2020-11-02,2020,2020,1990,2010,1742.331909,2103400,30,-10,2040,2051.428571,2044.761905,20,2010
ISAT.JK,2020-11-03,2040,2050,2000,2010,1742.331909,1033400,50,-30,2031.428571,2047.142857,2044.285714,17.72810521,1995
ISAT.JK,2020-11-04,2040,2050,1990,1995,1729.329346,4331100,60,-45,2027.142857,2042.857143,2045.238095,18.89822365,2120
ISAT.JK,2020-11-05,2020,2130,2000,2120,1837.68335,14215500,130,100,2019.285714,2038.214286,2041.666667,19.24157206,2140
ISAT.JK,2020-11-06,2120,2170,2060,2140,1855.02002,8798100,110,20,2030.714286,2042.5,2047.380952,42.85912694,2110
ISAT.JK,2020-11-09,2150,2150,2090,2110,1829.015137,5303800,60,-40,2043.571429,2046.071429,2053.095238,59.77138988,2090
ISAT.JK,2020-11-10,2130,2140,2090,2090,1811.678345,4388100,50,-40,2056.428571,2051.071429,2056.428571,63.42412039,2180
ISAT.JK,2020-11-11,2130,2230,2090,2180,1889.693237,11281900,140,50,2067.857143,2053.928571,2056.904762,60.81783886,2150
ISAT.JK,2020-11-12,2190,2200,2130,2150,1863.688477,4241500,70,-40,2092.142857,2061.785714,2062.142857,67.44486284,2200
ISAT.JK,2020-11-13,2170,2220,2150,2200,1907.029907,4786400,70,30,2112.142857,2069.642857,2065.952381,59.29145124,2220
ISAT.JK,2020-11-16,2200,2250,2200,2220,1924.366455,4248500,50,20,2141.428571,2080.357143,2072.619048,38.91382421,2230
ISAT.JK,2020-11-17,2250,2260,2220,2230,1933.03479,4764500,40,-20,2155.714286,2093.214286,2080.238095,47.20774755,2200
ISAT.JK,2020-11-18,2240,2250,2180,2200,1907.029907,4476800,70,-40,2168.571429,2106.071429,2086.904762,53.98412465,2190
ISAT.JK,2020-11-19,2200,2210,2180,2190,1898.361572,4394300,30,-10,2181.428571,2118.928571,2094.52381,48.10702354,2200
ISAT.JK,2020-11-20,2190,2220,2180,2200,1907.029907,8269000,40,10,2195.714286,2131.785714,2101.190476,26.367368,2280
ISAT.JK,2020-11-23,2210,2290,2190,2280,1976.376343,10993900,100,70,2198.571429,2145.357143,2107.380952,25.44836041,2320
ISAT.JK,2020-11-24,2310,2340,2280,2320,2011.049805,8225400,60,10,2217.142857,2164.642857,2118.809524,30.93772547,2300
ISAT.JK,2020-11-25,2330,2380,2280,2300,1993.713013,7864100,100,-30,2234.285714,2187.857143,2131.666667,48.25527358,2330
ISAT.JK,2020-11-26,2300,2370,2290,2330,2019.71814,3246300,80,30,2245.714286,2200.714286,2144.047619,53.49677338,2350
ISAT.JK,2020-11-27,2350,2370,2330,2350,2037.054565,3868100,40,0,2260,2214.285714,2157.380952,61.37317547,2200
ISAT.JK,2020-11-30,2350,2350,2200,2200,1907.029907,8941400,150,-150,2281.428571,2231.428571,2173.095238,63.09478886,2230
ISAT.JK,2020-12-01,2200,2270,2170,2230,1933.03479,4509200,100,30,2282.857143,2239.285714,2182.142857,60.74928963,2510
ISAT.JK,2020-12-02,2250,2520,2220,2510,2175.747803,79432000,300,260,2287.142857,2242.857143,2192.619048,54.68524655,2480
ISAT.JK,2020-12-03,2530,2550,2450,2480,2149.742676,25791500,100,-50,2320,2268.571429,2216.428571,100,2580
ISAT.JK,2020-12-04,2470,2660,2440,2580,2236.426025,45824900,220,110,2342.857143,2288.571429,2239.52381,116.8637791,2660
ISAT.JK,2020-12-07,2600,2730,2560,2660,2305.772461,29331100,170,60,2382.857143,2314.285714,2261.428571,144.4200224,2640
ISAT.JK,2020-12-08,2660,2710,2620,2640,2288.436035,16916200,90,-20,2430,2345,2286.190476,174.9285568,2560
ISAT.JK,2020-12-10,2640,2680,2500,2560,2219.089355,18399100,180,-80,2471.428571,2376.428571,2311.428571,186.7644302,2670
ISAT.JK,2020-12-11,2560,2670,2530,2670,2314.440918,15222700,140,110,2522.857143,2402.857143,2333.809524,144.3045721,3330
ISAT.JK,2020-12-14,2690,3330,2680,3330,2886.549805,106774100,650,640,2585.714286,2436.428571,2357.142857,74.35436388,3390
ISAT.JK,2020-12-15,3430,3740,3170,3390,2938.559814,67602600,570,-40,2702.857143,2511.428571,2413.333333,284.4125106,4230
ISAT.JK,2020-12-16,3470,4230,3430,4230,3666.698242,44270300,800,760,2832.857143,2587.857143,2470,362.7540161,3940
ISAT.JK,2020-12-17,4270,5000,3940,3940,3415.317139,96985000,1060,-330,3068.571429,2725.714286,2565.714286,617.6144583,4560
ISAT.JK,2020-12-18,3930,4660,3900,4560,3952.752686,70122700,760,630,3251.428571,2840.714286,2647.142857,664.2145379,5500
ISAT.JK,2020-12-21,4620,5700,4590,5500,4767.574707,88663500,1110,880,3525.714286,2998.571429,2759.52381,759.2728351,5250
ISAT.JK,2020-12-22,5625,6000,5125,5250,4550.866699,55457400,875,-375,3945.714286,3234.285714,2917.142857,929.9974398,5650
ISAT.JK,2020-12-23,5250,5850,4960,5650,4897.599609,71809400,890,400,4314.285714,3450,3062.380952,847.7589505,5650
ISAT.JK,2020-12-28,5650,5650,5650,5650,4897.599609,0,0,0,4645.714286,3674.285714,3222.857143,852.3077915,5275
ISAT.JK,2020-12-29,5800,6475,5275,5275,4572.537598,84006800,1200,-525,4968.571429,3900.714286,3381.428571,714.2228544,5050
ISAT.JK,2020-12-30,5250,5375,4930,5050,4377.500488,33870200,445,-200,5117.857143,4093.214286,3523.095238,639.4128631,5800
ISAT.JK,2021-01-04,5100,5825,5075,5800,5027.624023,49203300,750,700,5276.428571,4263.928571,3652.619048,386.0776507,5575
ISAT.JK,2021-01-05,5700,5950,5500,5575,4832.587402,26195300,450,-125,5453.571429,4489.642857,3816.904762,269.4239888,5450
ISAT.JK,2021-01-06,5625,5700,5275,5450,4724.233398,17929900,425,-175,5464.285714,4705,3977.619048,273.0449989,5900
ISAT.JK,2021-01-07,5525,5900,5450,5900,5114.307129,36782600,450,375,5492.857143,4903.571429,4130.952381,256.8698948,5900
ISAT.JK,2021-01-08,5900,5900,5900,5900,5114.307129,0,0,0,5528.571429,5087.142857,4292.380952,296.6579721,5900
ISAT.JK,2021-01-11,5900,5900,5900,5900,5114.307129,0,0,0,5564.285714,5266.428571,4455.238095,327.1904207,5900
ISAT.JK,2021-01-12,5900,5900,5900,5900,5114.307129,0,0,0,5653.571429,5385.714286,4613.333333,320.2956224,6375
ISAT.JK,2021-01-13,5950,6450,5775,6375,5526.052246,32808000,675,425,5775,5525.714286,4767.619048,186.525244,6200
ISAT.JK,2021-01-14,6400,6425,6050,6200,5374.356934,14430700,375,-200,5857.142857,5655.357143,4945.47619,294.6446609,6150
ISAT.JK,2021-01-15,6200,6375,6000,6150,5331.015625,8743700,375,-50,5946.428571,5705.357143,5118.809524,289.5501437,5725
ISAT.JK,2021-01-18,6150,6275,5725,5725,4962.611816,12987900,550,-425,6046.428571,5769.642857,5284.52381,194.9511538,5675
ISAT.JK,2021-01-19,5725,6050,5325,5675,4919.270508,15727600,725,-50,6021.428571,5775,5398.571429,225.6604065,5825
ISAT.JK,2021-01-20,5550,5975,5500,5825,5049.294922,8017200,475,275,5989.285714,5776.785714,5507.380952,259.3490019,5625
ISAT.JK,2021-01-21,5900,5925,5525,5625,4875.928711,4587200,400,-275,5978.571429,5816.071429,5583.333333,265.1369817,5475
ISAT.JK,2021-01-22,5625,5725,5300,5475,4745.904297,5238000,425,-150,5939.285714,5857.142857,5663.571429,297.1591685,5375
ISAT.JK,2021-01-25,5350,5600,5100,5375,4659.221191,5862400,500,25,5810.714286,5833.928571,5707.142857,270.746323,5425
ISAT.JK,2021-01-26,5375,5700,5125,5425,4702.5625,8630800,575,50,5692.857143,5819.642857,5701.190476,251.9566289,5500
ISAT.JK,2021-01-27,5500,5800,5275,5500,4767.574707,14300100,525,0,5589.285714,5817.857143,5709.52381,167.616342,5175
ISAT.JK,2021-01-28,5500,5550,5125,5175,4485.854492,10388100,425,-325,5557.142857,5789.285714,5702.380952,158.5837619,5025
ISAT.JK,2021-01-29,5175,5300,4820,5025,4355.82959,8935400,480,-150,5485.714286,5737.5,5679.761905,203.0276782,5100
ISAT.JK,2021-02-01,4900,5250,4770,5100,4420.842285,6319300,480,200,5371.428571,5675,5667.857143,205.3597308,5375
ISAT.JK,2021-02-02,5150,5550,5000,5375,4659.221191,9211400,550,225,5296.428571,5617.857143,5670.238095,192.8020203,5175
ISAT.JK,2021-02-03,5450,5450,5000,5175,4485.854492,7665800,450,-275,5282.142857,5546.428571,5650,180.6898158,5575
ISAT.JK,2021-02-04,5200,5900,5200,5575,4832.587402,26673800,700,375,5253.571429,5473.214286,5630.952381,179.3672742,5450
ISAT.JK,2021-02-05,5625,5650,5325,5450,4724.233398,6752700,325,-175,5275,5432.142857,5636.904762,209.6624271,5500
ISAT.JK,2021-02-08,5500,5675,5450,5500,4767.574707,8022400,225,0,5267.857143,5412.5,5615.47619,201.4087292,5500
ISAT.JK,2021-02-09,5600,5725,5400,5500,4767.574707,6527900,325,-100,5314.285714,5400,5596.428571,213.5304149,5800
ISAT.JK,2021-02-10,5575,5850,5350,5800,5027.624023,14106600,500,225,5382.142857,5376.785714,5577.380952,178.9519755,5950
ISAT.JK,2021-02-11,5825,6150,5800,5950,5157.649414,12824600,350,125,5482.142857,5389.285714,5572.619048,190.2379462,6050
ISAT.JK,2021-02-15,5950,6100,5900,6050,5244.33252,7422600,200,100,5564.285714,5423.214286,5552.380952,250.7726157,6075
ISAT.JK,2021-02-16,6050,6100,5875,6075,5266.003418,7485900,225,25,5689.285714,5471.428571,5545.238095,242.322591,5775
ISAT.JK,2021-02-17,6025,6075,5650,5775,5005.953613,9238700,425,-250,5760.714286,5517.857143,5541.666667,274.5667583,5575
ISAT.JK,2021-02-18,5675,5800,5550,5575,4832.587402,6714500,250,-100,5807.142857,5537.5,5544.047619,238.3599719,5700
ISAT.JK,2021-02-19,5575,5725,5275,5700,4940.940918,5512200,450,125,5817.857143,5566.071429,5539.285714,223.4736588,6000
ISAT.JK,2021-02-22,5900,6050,5750,6000,5200.990723,17604100,300,100,5846.428571,5614.285714,5533.333333,185.6455917,5800
ISAT.JK,2021-02-23,6000,6050,5650,5800,5027.624023,14585900,400,-200,5875,5678.571429,5551.190476,192.5703335,5675
ISAT.JK,2021-02-24,5825,5950,5625,5675,4919.270508,7099100,325,-150,5853.571429,5708.928571,5566.666667,191.1743159,5700
ISAT.JK,2021-02-25,5700,5775,5650,5700,4940.940918,4410300,125,0,5800,5744.642857,5580.952381,179.1182105,5550
ISAT.JK,2021-02-26,5600,5800,5550,5550,4810.916504,9904500,250,-50,5746.428571,5753.571429,5594.047619,133.4077173,5775
ISAT.JK,2021-03-01,5550,5950,5375,5775,5005.953613,7796800,575,225,5714.285714,5760.714286,5596.428571,151.2841854,5575
ISAT.JK,2021-03-02,5775,5825,5575,5575,4832.587402,3508800,250,-200,5742.857143,5780.357143,5625,138.9801288,5650
ISAT.JK,2021-03-03,5575,5700,5575,5650,4897.599609,1920000,125,75,5725,5785.714286,5651.190476,152.7525232,5750
ISAT.JK,2021-03-04,5650,6050,5575,5750,4984.282715,8914000,475,100,5675,5775,5677.380952,93.54143467,5625
ISAT.JK,2021-03-05,5750,5750,5575,5625,4875.928711,4176900,175,-125,5667.857143,5760.714286,5695.238095,83.80817098,5675
ISAT.JK,2021-03-08,5700,5725,5600,5675,4919.270508,3045900,125,-25,5660.714286,5730.357143,5716.666667,85.21681032,5600
ISAT.JK,2021-03-09,5675,5875,5600,5600,4854.257813,7766000,275,-75,5657.142857,5701.785714,5721.428571,83.80817098,5450
ISAT.JK,2021-03-10,5575,5700,5400,5450,4724.233398,3419500,300,-125,5664.285714,5689.285714,5728.571429,74.80132415,5650
ISAT.JK,2021-03-12,5450,5650,5400,5650,4897.599609,3818600,250,200,5617.857143,5680.357143,5726.190476,93.22272357,5625
ISAT.JK,2021-03-15,5650,5750,5625,5625,4875.928711,3364200,125,-25,5628.571429,5676.785714,5733.333333,91.77482796,6175
ISAT.JK,2021-03-16,5625,6600,5625,6175,5352.686523,44058500,975,550,5625,5650,5725,91.28709292,6050
ISAT.JK,2021-03-17,6175,6450,5950,6050,5244.33252,14434100,500,-125,5685.714286,5676.785714,5735.714286,227.6954942,6600
ISAT.JK,2021-03-18,6100,7025,5975,6600,5721.089844,30092900,1050,500,5746.428571,5703.571429,5735.714286,262.7691364,6650
ISAT.JK,2021-03-19,6625,6950,6500,6650,5764.431641,39537200,450,25,5878.571429,5767.857143,5760.714286,411.4072828,6200
ISAT.JK,2021-03-22,6700,6700,6200,6200,5374.356934,6458500,500,-500,6028.571429,5846.428571,5802.380952,478.8068007,6150
ISAT.JK,2021-03-23,6200,6400,6000,6150,5331.015625,10871200,400,-50,6135.714286,5876.785714,5832.142857,406.1652842,6150
ISAT.JK,2021-03-24,6150,6350,6050,6150,5331.015625,3661400,300,0,6207.142857,5917.857143,5853.571429,346.023327,6675
ISAT.JK,2021-03-25,6200,6800,6125,6675,5786.102051,15647100,675,475,6282.142857,5953.571429,5860.714286,239.2324034,6475
ISAT.JK,2021-03-26,6700,6750,6400,6475,5612.735352,6629300,350,-225,6353.571429,6019.642857,5902.380952,274.0242429,6400
ISAT.JK,2021-03-29,6500,6675,6400,6400,5547.723145,4137600,275,-100,6414.285714,6080.357143,5940.47619,240.5969758,6250
ISAT.JK,2021-03-30,6500,6500,6150,6250,5417.69873,5198600,350,-250,6385.714286,6132.142857,5973.809524,226.3188859,6275
ISAT.JK,2021-03-31,6350,6675,5900,6275,5439.369629,12152100,775,-75,6328.571429,6178.571429,6007.142857,197.0768523,6400
ISAT.JK,2021-04-01,6250,6400,6175,6400,5547.723145,3360900,225,150,6339.285714,6237.5,6030.952381,190.8627031,6375
ISAT.JK,2021-04-05,6400,6475,6150,6375,5526.052246,3600900,325,-25,6375,6291.071429,6070.238095,171.998062,6900
ISAT.JK,2021-04-06,6400,7300,6300,6900,5981.13916,15611600,1000,500,6407.142857,6344.642857,6104.761905,141.210751,6850
ISAT.JK,2021-04-07,6950,7100,6725,6850,5937.797852,6449700,375,-100,6439.285714,6396.428571,6159.52381,217.398033,6700
ISAT.JK,2021-04-08,6850,7075,6650,6700,5807.772949,5184400,425,-150,6492.857143,6453.571429,6217.857143,267.9840969,6625
ISAT.JK,2021-04-09,6700,6850,6500,6625,5742.760742,6122700,350,-75,6535.714286,6460.714286,6266.666667,274.5667583,6350
ISAT.JK,2021-04-12,6600,6750,6325,6350,5504.381836,5837000,425,-250,6589.285714,6458.928571,6315.47619,244.4624813,6525
ISAT.JK,2021-04-13,6350,6775,6175,6525,5656.077637,9280000,600,175,6600,6469.642857,6358.333333,229.5829552,6700
ISAT.JK,2021-04-14,6575,6750,6450,6700,5807.772949,5212300,300,125,6617.857143,6496.428571,6400,215.8868751,6475
ISAT.JK,2021-04-15,6750,6750,6450,6475,5612.735352,2341500,300,-275,6664.285714,6535.714286,6451.190476,188.1140738,6525
ISAT.JK,2021-04-16,6525,6625,6475,6525,5656.077637,1735300,150,0,6603.571429,6521.428571,6465.47619,166.7261799,6400
ISAT.JK,2021-04-19,6550,6700,6400,6400,5547.723145,6527100,300,-150,6557.142857,6525,6488.095238,127.2418021,6425
ISAT.JK,2021-04-20,6400,6500,6300,6425,5569.394043,1836700,200,25,6514.285714,6525,6478.571429,121.4985793,6500
ISAT.JK,2021-04-21,6400,6525,6400,6500,5634.406738,2133000,125,100,6485.714286,6537.5,6467.857143,114.4344271,6475
ISAT.JK,2021-04-22,6400,6575,6400,6475,5612.735352,1868700,175,75,6507.142857,6553.571429,6482.142857,97.59000729,6475
ISAT.JK,2021-04-23,6475,6550,6450,6475,5612.735352,2422500,100,0,6500,6558.928571,6497.619048,97.89450104,6550
ISAT.JK,2021-04-26,6475,6650,6450,6550,5677.748535,1555800,200,75,6467.857143,6566.071429,6513.095238,42.60840516,6450
ISAT.JK,2021-04-27,6600,6625,6400,6450,5591.064941,2838200,225,-150,6478.571429,6541.071429,6507.142857,52.89252355,6525
ISAT.JK,2021-04-28,6450,6575,6450,6525,5656.077637,1412500,125,75,6467.857143,6512.5,6505.952381,49.401176,6550
ISAT.JK,2021-04-29,6500,6550,6400,6550,5677.748535,2275700,150,50,6485.714286,6500,6511.904762,42.95623465,6575
ISAT.JK,2021-04-30,6550,6625,6450,6575,5699.418945,2427400,175,25,6503.571429,6494.642857,6526.190476,39.33978962,6275
ISAT.JK,2021-05-03,6575,6575,6175,6275,5439.369629,3042600,400,-300,6514.285714,6510.714286,6540.47619,47.55948656,6200
ISAT.JK,2021-05-04,6175,6325,6075,6200,5374.356934,1298800,250,25,6485.714286,6492.857143,6534.52381,102.933173,6300
ISAT.JK,2021-05-05,6225,6400,6200,6300,5461.040039,1210200,200,75,6446.428571,6457.142857,6526.190476,149.6026483,6275
ISAT.JK,2021-05-06,6325,6400,6250,6275,5439.369629,1021300,150,-50,6410.714286,6444.642857,6497.619048,150.5940617,6200
ISAT.JK,2021-05-07,6275,6450,6100,6200,5374.356934,4260400,350,-75,6385.714286,6426.785714,6470.238095,157.3591585,6125
ISAT.JK,2021-05-10,6225,6225,6100,6125,5309.344727,1568800,125,-100,6339.285714,6412.5,6446.428571,157.3591585,6075
ISAT.JK,2021-05-11,6125,6175,6025,6075,5266.003418,1771900,150,-50,6278.571429,6391.071429,6422.619048,143.9245834,5975
ISAT.JK,2021-05-17,6075,6100,5825,5975,5179.320313,2160300,275,-100,6207.142857,6360.714286,6409.52381,83.80817098,6100
ISAT.JK,2021-05-18,5975,6150,5850,6100,5287.673828,2186700,300,125,6164.285714,6325,6383.333333,114.4344271,5950
ISAT.JK,2021-05-19,6100,6150,5925,5950,5157.649414,1057400,225,-150,6150,6298.214286,6354.761905,115.4700538,6375
ISAT.JK,2021-05-20,5950,6500,5900,6375,5526.052246,5968900,600,425,6100,6255.357143,6329.761905,115.4700538,6600
ISAT.JK,2021-05-21,6400,6775,6400,6600,5721.089844,7454000,375,200,6114.285714,6250,6322.619048,143.5104111,6300
ISAT.JK,2021-05-24,6600,6700,6150,6300,5461.040039,5223400,550,-300,6171.428571,6255.357143,6332.142857,234.2668401,6400
ISAT.JK,2021-05-25,6425,6425,6200,6400,5547.723145,1151000,225,-25,6196.428571,6237.5,6326.190476,237.7974328,6200
ISAT.JK,2021-05-27,6400,6500,6200,6200,5374.356934,2473900,300,-200,6242.857143,6225,6321.428571,241.8308145,6250
ISAT.JK,2021-05-28,6225,6375,6200,6250,5417.69873,1912700,175,25,6275,6219.642857,6308.333333,213.6000936,6350
ISAT.JK,2021-05-31,6250,6475,6250,6350,5504.381836,1839600,225,100,6296.428571,6223.214286,6297.619048,200.2230899,6625
ISAT.JK,2021-06-02,6350,6750,6350,6625,5742.760742,3440800,400,275,6353.571429,6226.785714,6288.095238,129.4447851,6925
ISAT.JK,2021-06-03,6650,7000,6500,6925,6002.810059,3384500,500,275,6389.285714,6251.785714,6296.428571,165.7414797,6650
ISAT.JK,2021-06-04,6925,6950,6600,6650,5764.431641,1879300,350,-275,6435.714286,6303.571429,6315.47619,255.7086326,6700
ISAT.JK,2021-06-07,6750,6850,6650,6700,5807.772949,1170300,200,-50,6485.714286,6341.071429,6320.238095,258.9470437,6375
ISAT.JK,2021-06-08,6700,6700,6300,6375,5526.052246,2439100,400,-325,6528.571429,6385.714286,6326.190476,267.0941514,6800
ISAT.JK,2021-06-09,6375,6950,6350,6800,5894.456055,3821900,600,425,6553.571429,6414.285714,6330.952381,237.7974328,6900
ISAT.JK,2021-06-10,6875,7200,6800,6900,5981.13916,4109300,400,25,6632.142857,6464.285714,6359.52381,210.0170061,6775
ISAT.JK,2021-06-11,6950,7075,6650,6775,5872.785156,2316600,425,-175,6710.714286,6532.142857,6388.095238,188.6670032,6900
ISAT.JK,2021-06-14,6775,6975,6775,6900,5981.13916,1485800,200,125,6732.142857,6560.714286,6411.904762,185.8058382,6750
ISAT.JK,2021-06-15,6925,7000,6600,6750,5851.114746,2062500,400,-175,6728.571429,6582.142857,6445.238095,181.6754039,6525
ISAT.JK,2021-06-16,6750,6800,6500,6525,5656.077637,1987800,300,-225,6742.857143,6614.285714,6475,178.3689328,6550
ISAT.JK,2021-06-17,6525,6625,6450,6550,5677.748535,1370300,175,25,6717.857143,6623.214286,6496.428571,196.6989481,6825
ISAT.JK,2021-06-18,6600,6850,6500,6825,5916.126953,4398100,350,225,6742.857143,6648.214286,6523.809524,151.8732241,7100
ISAT.JK,2021-06-21,6825,7125,6500,7100,6154.505859,4407400,625,275,6746.428571,6689.285714,6558.333333,153.7236234,7200
ISAT.JK,2021-06-22,7100,7425,6950,7200,6241.188965,4330000,475,100,6775,6742.857143,6613.095238,198.9556064,6975
ISAT.JK,2021-06-23,7200,7375,6975,6975,6046.151367,1869800,400,-225,6835.714286,6783.928571,6652.380952,255.7086326,6875
ISAT.JK,2021-06-24,6975,6975,6800,6875,5959.468262,1821100,175,-100,6846.428571,6787.5,6670.238095,260.3797593,6950
ISAT.JK,2021-06-25,6850,6950,6775,6950,6024.480957,804100,175,100,6864.285714,6803.571429,6697.619048,256.9278201,6900
ISAT.JK,2021-06-28,7000,7100,6825,6900,5981.13916,971000,275,-100,6925,6821.428571,6723.809524,209.1650066,7050
ISAT.JK,2021-06-29,6925,7050,6700,7050,6111.164063,2207300,350,125,6975,6858.928571,6757.142857,132.2875656,6850
ISAT.JK,2021-06-30,7200,7200,6800,6850,5937.797852,2608400,400,-350,7007.142857,6876.785714,6795.238095,116.1126301,6425
ISAT.JK,2021-07-01,6825,6825,6425,6425,5569.394043,4775100,400,-400,6971.428571,6873.214286,6819.047619,121.1305868,6400
ISAT.JK,2021-07-02,6425,6600,6375,6400,5547.723145,1299800,225,-25,6860.714286,6848.214286,6809.52381,203.5400978,6275
ISAT.JK,2021-07-05,6400,6500,6250,6275,5439.369629,1174400,250,-125,6778.571429,6812.5,6784.52381,258.3717329,6350
ISAT.JK,2021-07-06,6300,6425,6300,6350,5504.381836,1244500,125,50,6692.857143,6778.571429,6766.666667,314.4818111,6150
ISAT.JK,2021-07-07,6375,6375,6050,6150,5331.015625,3955000,325,-225,6607.142857,6766.071429,6750,314.4818111,6075
ISAT.JK,2021-07-08,6175,6200,6050,6075,5266.003418,3336700,150,-100,6500,6737.5,6739.285714,325.6403947,6075
ISAT.JK,2021-07-09,6100,6200,6000,6075,5266.003418,1535900,200,-25,6360.714286,6683.928571,6704.761905,251.1876551,6450
ISAT.JK,2021-07-12,6100,6500,6075,6450,5591.064941,3402700,425,350,6250,6610.714286,6665.47619,150,6075
ISAT.JK,2021-07-13,6450,6500,6050,6075,5266.003418,3791700,450,-375,6253.571429,6557.142857,6650,155.0729475,6100
ISAT.JK,2021-07-14,6075,6125,6025,6100,5287.673828,1031200,100,25,6207.142857,6492.857143,6610.714286,152.5575613,6125
ISAT.JK,2021-07-15,6100,6200,6100,6125,5309.344727,1101800,100,25,6182.142857,6437.5,6579.761905,153.9171082,6075
ISAT.JK,2021-07-16,6150,6150,6050,6075,5266.003418,838200,100,-75,6150,6378.571429,6560.714286,135.4006401,6150
ISAT.JK,2021-07-19,6075,6225,6025,6150,5331.015625,1871800,200,75,6139.285714,6319.642857,6538.095238,138.3362019,6050
ISAT.JK,2021-07-21,6175,6225,6050,6050,5244.33252,1581300,175,-125,6150,6255.357143,6505.952381,135.4006401,6100
ISAT.JK,2021-07-22,6075,6175,6050,6100,5287.673828,1793100,125,25,6146.428571,6198.214286,6455.952381,138.0131119,5950
ISAT.JK,2021-07-23,6100,6125,5950,5950,5157.649414,2172400,175,-150,6096.428571,6175,6403.571429,33.62963546,6050
ISAT.JK,2021-07-26,5950,6075,5950,6050,5244.33252,1772300,125,100,6078.571429,6142.857143,6354.761905,65.23766076,5925
ISAT.JK,2021-07-27,6100,6150,5750,5925,5135.978516,3153000,400,-175,6071.428571,6126.785714,6315.47619,65.23766076,5700
ISAT.JK,2021-07-28,5950,5975,5675,5700,4940.940918,2438300,300,-250,6042.857143,6096.428571,6266.666667,79.99255918,6000
ISAT.JK,2021-07-29,5950,6125,5750,6000,5200.990723,7042600,375,50,5989.285714,6064.285714,6209.52381,149.9007608,5900
ISAT.JK,2021-07-30,6100,6275,5800,5900,5114.307129,2934200,475,-200,5967.857143,6058.928571,6159.52381,132.8488221,5950
ISAT.JK,2021-08-02,5950,6075,5900,5950,5157.649414,1286400,175,0,5946.428571,6046.428571,6114.285714,129.4447851,5950
ISAT.JK,2021-08-03,5950,6000,5900,5950,5157.649414,2405100,100,0,5925,6010.714286,6091.666667,110.8677891,5975
ISAT.JK,2021-08-04,6000,6075,5900,5975,5179.320313,1483100,175,-25,5925,6001.785714,6070.238095,110.8677891,6100
ISAT.JK,2021-08-05,6025,6100,5900,6100,5287.673828,1616800,200,75,5914.285714,5992.857143,6055.952381,99.85107959,6150
ISAT.JK,2021-08-06,6100,6200,6000,6150,5331.015625,2123000,200,50,5939.285714,5991.071429,6044.047619,122.3529243,6000
ISAT.JK,2021-08-09,6050,6175,5950,6000,5200.990723,1046600,225,-50,6003.571429,5996.428571,6044.047619,89.47598773,6175
ISAT.JK,2021-08-10,6000,6175,5800,6175,5352.686523,2382400,375,175,6003.571429,5985.714286,6040.47619,89.47598773,6325
ISAT.JK,2021-08-12,6200,6525,6100,6325,5482.710938,5204700,425,125,6042.857143,5994.642857,6045.238095,96.51671457,6500
ISAT.JK,2021-08-13,6350,6700,6325,6500,5634.406738,6732100,375,150,6096.428571,6010.714286,6039.285714,133.4077173,6275
ISAT.JK,2021-08-16,6575,6575,6100,6275,5439.369629,5737200,475,-300,6175,6050,6059.52381,184.8422751,5975
ISAT.JK,2021-08-18,6100,6100,5875,5975,5179.320313,4825700,225,-125,6217.857143,6066.071429,6067.857143,164.3892014,6100
ISAT.JK,2021-08-19,5975,6350,5950,6100,5287.673828,4699100,400,125,6200,6069.642857,6060.714286,184.8422751,6525
ISAT.JK,2021-08-20,6000,6600,6000,6525,5656.077637,3325400,600,525,6192.857143,6098.214286,6061.904762,188.0349512,6500
ISAT.JK,2021-08-23,6500,6600,6425,6500,5634.406738,1067700,175,0,6267.857143,6135.714286,6079.761905,202.4404674,6350
ISAT.JK,2021-08-24,6450,6525,6350,6350,5504.381836,546300,175,-100,6314.285714,6178.571429,6101.190476,214.5038572,6425
ISAT.JK,2021-08-25,6350,6500,6325,6425,5569.394043,731000,175,75,6317.857143,6207.142857,6113.095238,214.9196971,6400
ISAT.JK,2021-08-26,6525,6550,6350,6400,5547.723145,961200,200,-125,6307.142857,6241.071429,6135.714286,206.0108643,6350
ISAT.JK,2021-08-27,6400,6400,6350,6350,5504.381836,271500,50,-50,6325,6271.428571,6152.380952,208.1665999,6425
ISAT.JK,2021-08-30,6500,6525,6350,6425,5569.394043,766400,175,-75,6378.571429,6289.285714,6172.619048,140.259114,6325
ISAT.JK,2021-08-31,6425,6450,6325,6325,5482.710938,990600,125,-100,6425,6308.928571,6207.142857,67.70032004,6250
ISAT.JK,2021-09-01,6325,6375,6200,6250,5417.69873,1532200,175,-75,6396.428571,6332.142857,6222.619048,60.25738445,6300
ISAT.JK,2021-09-02,6250,6325,6200,6300,5461.040039,289700,125,50,6360.714286,6337.5,6239.285714,62.67831705,6300
ISAT.JK,2021-09-03,6300,6375,6250,6300,5461.040039,568000,125,0,6353.571429,6335.714286,6255.952381,66.81531048,6600
ISAT.JK,2021-09-06,6300,6750,6275,6600,5721.089844,2895900,475,300,6335.714286,6321.428571,6272.619048,60.99375456,6700
ISAT.JK,2021-09-07,6600,6850,6600,6700,5807.772949,3448700,250,100,6364.285714,6344.642857,6302.380952,117.1334201,6475
ISAT.JK,2021-09-08,6700,6800,6475,6475,5612.735352,1909500,325,-225,6414.285714,6396.428571,6330.952381,171.9115221,6675
ISAT.JK,2021-09-09,6475,6750,6475,6675,5786.102051,1401000,275,200,6421.428571,6423.214286,6346.428571,173.4626349,6675
ISAT.JK,2021-09-10,6725,6800,6650,6675,5786.102051,2977500,150,-50,6471.428571,6433.928571,6378.571429,190.6286592,6725
ISAT.JK,2021-09-13,6675,6800,6500,6725,5829.443848,1248000,300,50,6532.142857,6446.428571,6402.380952,175.4246548,6975
ISAT.JK,2021-09-14,6775,7125,6725,6975,6046.151367,6493600,400,200,6592.857143,6473.214286,6421.428571,153.9171082,7000
ISAT.JK,2021-09-15,7000,7125,6900,7000,6067.822266,1966800,225,0,6689.285714,6512.5,6444.047619,151.2841854,7125
ISAT.JK,2021-09-16,7000,7275,7000,7125,6176.176758,5285400,275,125,6746.428571,6555.357143,6478.571429,183.9545751,6900
ISAT.JK,2021-09-17,7550,7675,6775,6900,5981.13916,16863400,900,-650,6807.142857,6610.714286,6533.333333,230.35945,6800
ISAT.JK,2021-09-20,6900,7050,6775,6800,5894.456055,6565800,275,-100,6867.857143,6644.642857,6571.428571,178.3689328,6850
ISAT.JK,2021-09-21,6800,6925,6750,6850,5937.797852,2045900,175,50,6885.714286,6678.571429,6584.52381,161.2820658,6725
ISAT.JK,2021-09-22,6950,6950,6650,6725,5829.443848,3160200,300,-225,6910.714286,6721.428571,6601.190476,134.5185418,6700
ISAT.JK,2021-09-23,6725,6800,6550,6700,5807.772949,5424900,250,-25,6910.714286,6751.785714,6619.047619,134.5185418,6600
ISAT.JK,2021-09-24,6700,6700,6500,6600,5721.089844,3992400,200,-100,6871.428571,6780.357143,6632.142857,151.677132,6400
ISAT.JK,2021-09-27,6700,6700,6350,6400,5547.723145,4441300,350,-300,6814.285714,6780.357143,6641.666667,169.4704638,6275
ISAT.JK,2021-09-28,6400,6500,6275,6275,5439.369629,3521400,225,-125,6710.714286,6758.928571,6644.047619,169.4704638,6450
ISAT.JK,2021-09-29,6275,6450,6250,6450,5591.064941,1357800,200,175,6621.428571,6744.642857,6636.904762,212.3423785,6650
ISAT.JK,2021-09-30,6450,6800,6350,6650,5764.431641,4892000,450,200,6571.428571,6728.571429,6642.857143,204.3427326,6275
ISAT.JK,2021-10-01,6650,6650,6250,6275,5439.369629,4768000,400,-375,6542.857143,6726.785714,6661.904762,169.9964986,6375
ISAT.JK,2021-10-04,6325,6525,6275,6375,5526.052246,2703700,250,50,6478.571429,6694.642857,6660.714286,174.6595328,6400
ISAT.JK,2021-10-05,6375,6450,6300,6400,5547.723145,2197500,150,25,6432.142857,6651.785714,6664.285714,146.9936831,6375
ISAT.JK,2021-10-06,6400,6450,6350,6375,5526.052246,2286600,100,-25,6403.571429,6608.928571,6654.761905,127.0076863,6400
ISAT.JK,2021-10-07,6300,6450,6275,6400,5547.723145,3374100,175,100,6400,6555.357143,6639.285714,127.4754878,6350
ISAT.JK,2021-10-08,6400,6475,6325,6350,5504.381836,3690200,150,-50,6417.857143,6519.642857,6635.714286,115.2120199,6300
ISAT.JK,2021-10-11,6350,6450,6300,6300,5461.040039,2224100,150,-50,6403.571429,6487.5,6620.238095,116.7516697,6150
ISAT.JK,2021-10-12,6300,6400,6150,6150,5331.015625,4268700,250,-150,6353.571429,6448.214286,6602.380952,48.79500365,6100
ISAT.JK,2021-10-13,6175,6275,6050,6100,5287.673828,4609900,225,-75,6335.714286,6407.142857,6575,88.80824715,6275
ISAT.JK,2021-10-14,6100,6275,6100,6275,5439.369629,4115100,175,175,6296.428571,6364.285714,6533.333333,122.8384537,6500
ISAT.JK,2021-10-15,6325,6625,6275,6500,5634.406738,5169700,350,175,6278.571429,6341.071429,6498.809524,114.0436424,6800
ISAT.JK,2021-10-18,6500,6800,6450,6800,5894.456055,4572700,350,300,6296.428571,6348.214286,6469.047619,138.7658185,6900
ISAT.JK,2021-10-19,6800,6975,6800,6900,5981.13916,4584600,175,100,6353.571429,6385.714286,6464.285714,236.4796377,6900
ISAT.JK,2021-10-21,6900,6950,6675,6900,5981.13916,5904100,275,0,6432.142857,6417.857143,6469.047619,313.8186464,7175
ISAT.JK,2021-10-22,6900,7575,6850,7175,6219.518066,10201500,725,275,6517.857143,6435.714286,6471.428571,351.4002602,6975
ISAT.JK,2021-10-25,7200,7375,6950,6975,6046.151367,4344400,425,-225,6664.285714,6500,6492.857143,384.5606646,6925
ISAT.JK,2021-10-26,7050,7100,6900,6925,6002.810059,1235400,200,-125,6789.285714,6542.857143,6505.952381,304.4315546,6950
ISAT.JK,2021-10-27,6925,7100,6875,6950,6024.480957,2068800,225,25,6882.142857,6580.357143,6521.428571,203.9782902,7100
ISAT.JK,2021-10-28,6950,7275,6900,7100,6154.505859,5542400,375,150,6946.428571,6621.428571,6547.619048,114.9534067,6925
ISAT.JK,2021-10-29,7100,7150,6900,6925,6002.810059,4153900,250,-175,6989.285714,6671.428571,6586.904762,106.9044968,7325
ISAT.JK,2021-11-01,6925,7400,6925,7325,6349.542969,7510500,475,400,6992.857143,6712.5,6609.52381,103.796963,7050
ISAT.JK,2021-11-02,7325,7475,7025,7050,6111.164063,3069200,450,-275,7053.571429,6785.714286,6641.666667,153.0445002,7000
ISAT.JK,2021-11-03,7050,7075,6925,7000,6067.822266,3564100,150,-50,7035.714286,6850,6678.571429,143.5104111,7175
ISAT.JK,2021-11-04,7050,7175,7000,7175,6219.518066,3106200,175,125,7039.285714,6914.285714,6708.333333,142.0512986,7000
ISAT.JK,2021-11-05,7050,7175,6950,7000,6067.822266,2766300,225,-50,7075,6978.571429,6745.238095,139.9404635,7225
ISAT.JK,2021-11-08,7050,7250,7000,7225,6262.859863,1622200,250,175,7082.142857,7014.285714,6775,133.630621,7075
ISAT.JK,2021-11-09,7300,7300,7025,7075,6132.834961,3676900,275,-225,7100,7044.642857,6814.285714,144.3375673,7000
ISAT.JK,2021-11-10,7100,7150,6950,7000,6067.822266,2570300,200,-100,7121.428571,7057.142857,6848.809524,123.683544,7050
ISAT.JK,2021-11-11,7025,7100,7000,7050,6111.164063,1427700,100,25,7075,7064.285714,6882.142857,91.28709292,7000
ISAT.JK,2021-11-12,7075,7100,6950,7000,6067.822266,1172700,150,-75,7075,7055.357143,6925,91.28709292,6925
ISAT.JK,2021-11-15,7000,7000,6850,6925,6002.810059,1550500,150,-75,7075,7057.142857,6967.857143,91.28709292,7000
ISAT.JK,2021-11-16,6925,7050,6850,7000,6067.822266,1006700,200,75,7039.285714,7057.142857,6998.809524,94.49111825,7000
ISAT.JK,2021-11-17,7000,7050,6925,7000,6067.822266,608600,125,0,7039.285714,7060.714286,7022.619048,94.49111825,6800
ISAT.JK,2021-11-18,6900,6950,6600,6800,5894.456055,6106600,350,-100,7007.142857,7053.571429,7032.142857,47.24555913,6900
ISAT.JK,2021-11-19,6700,6925,6700,6900,5981.13916,3349800,225,200,6967.857143,7044.642857,7027.380952,82.55589737,6825
ISAT.JK,2021-11-22,6875,6975,6775,6825,5916.126953,1056600,200,-50,6953.571429,7014.285714,7027.380952,84.69131625,6950
ISAT.JK,2021-11-23,6825,7000,6825,6950,6024.480957,1405300,175,125,6921.428571,6998.214286,7010.714286,84.69131625,6900
ISAT.JK,2021-11-24,7000,7000,6800,6900,5981.13916,1821500,200,-100,6914.285714,6994.642857,7009.52381,78.86848607,7125
ISAT.JK,2021-11-25,6900,7175,6900,7125,6176.176758,3131400,275,225,6910.714286,6975,7008.333333,78.86848607,7400
ISAT.JK,2021-11-26,7400,7700,7200,7400,6414.555176,29460200,500,0,6928.571429,6983.928571,7016.666667,110.3295928,7850
ISAT.JK,2021-11-29,7400,7850,7400,7850,6804.629395,15501700,450,450,6985.714286,6996.428571,7030.952381,211.0771694,8150
ISAT.JK,2021-11-30,7925,8250,7900,8150,7064.678711,15104900,350,225,7135.714286,7051.785714,7075,370.2074708,7850
ISAT.JK,2021-12-01,8050,8300,7850,7850,6804.629395,13468800,450,-200,7314.285714,7133.928571,7114.285714,511.9116832,7775
ISAT.JK,2021-12-02,7850,8025,7725,7775,6739.617188,9717100,300,-75,7460.714286,7191.071429,7152.380952,494.9446819,7800
ISAT.JK,2021-12-03,7800,7925,7700,7800,6761.288086,8909900,225,0,7578.571429,7246.428571,7189.285714,449.1725196,8100
ISAT.JK,2021-12-06,7950,8100,7850,8100,7021.337402,22376000,250,150,7707.142857,7308.928571,7219.047619,337.4889769,7550
ISAT.JK,2021-12-07,7550,7550,7550,7550,7289.885254,844600,0,0,7846.428571,7387.5,7271.428571,245.9795772,7025
ISAT.JK,2021-12-08,7025,7025,7025,7025,6782.972656,1576600,0,0,7867.857143,7426.785714,7286.904762,203.466974,6550
ISAT.JK,2021-12-09,6550,6550,6550,6550,6324.337891,2806500,0,0,7750,7442.857143,7284.52381,378.8689307,6250
ISAT.JK,2021-12-10,6550,6550,6150,6250,6034.67334,20733800,400,-300,7521.428571,7417.857143,7263.095238,543.9877012,6350
ISAT.JK,2021-12-13,6250,6450,6250,6350,6131.228027,8370400,200,100,7292.857143,7376.785714,7225,697.4229775,6275
ISAT.JK,2021-12-14,6400,6450,6225,6275,6058.812012,3909400,225,-125,7089.285714,7333.928571,7194.047619,739.9123178,6200
ISAT.JK,2021-12-15,6275,6325,6200,6200,5986.395996,2705100,125,-75,6871.428571,7289.285714,7163.095238,720.0157075,6100
ISAT.JK,2021-12-16,6200,6275,6000,6100,5889.841309,6492200,275,-100,6600,7223.214286,7125,506.0055994,6050
ISAT.JK,2021-12-17,6100,6125,6000,6050,5841.563965,5058300,125,-50,6392.857143,7130.357143,7082.142857,311.8206902,5925
ISAT.JK,2021-12-20,6025,6075,5925,5925,5720.870605,3789300,150,-100,6253.571429,7001.785714,7046.428571,166.1002279,5825
ISAT.JK,2021-12-21,5925,5975,5750,5825,5624.31543,5637300,225,-100,6164.285714,6842.857143,7000,147.0948835,5650
ISAT.JK,2021-12-22,5825,5875,5600,5650,5455.344727,5934300,275,-175,6103.571429,6698.214286,6952.380952,187.8766059,5600
ISAT.JK,2021-12-23,5675,5675,5500,5600,5407.067383,6220600,175,-75,6003.571429,6546.428571,6890.47619,218.6266659,5525
ISAT.JK,2021-12-24,5600,5625,5475,5525,5334.651367,3396700,150,-75,5907.142857,6389.285714,6828.571429,227.6301302,5900
ISAT.JK,2021-12-27,5525,5975,5525,5900,5696.731445,8550700,450,375,5810.714286,6205.357143,6752.380952,225.8581519,5850
ISAT.JK,2021-12-28,5950,6025,5825,5850,5648.454102,6118000,200,-100,5782.142857,6087.5,6680.952381,193.4954165,6150
ISAT.JK,2021-12-29,5975,6200,5825,6150,5938.118652,7304300,375,175,5753.571429,6003.571429,6585.714286,159.0522526,6200
ISAT.JK,2021-12-30,6250,6300,6100,6200,5986.395996,6118800,200,-50,5785.714286,5975,6490.47619,213.0420258,6425
ISAT.JK,2022-01-03,6200,6450,6175,6425,6203.644043,8106600,275,225,5839.285714,5971.428571,6411.904762,265.3053048,6250
ISAT.JK,2022-01-04,6425,6475,6150,6250,6034.67334,6697700,325,-175,5950,5976.785714,6347.619048,327.5540668,6150
ISAT.JK,2022-01-05,6300,6350,6050,6150,5938.118652,5903500,300,-150,6042.857143,5975,6273.809524,303.0106866,6300
ISAT.JK,2022-01-06,6150,6325,6125,6300,6082.950684,3908300,200,150,6132.142857,5971.428571,6180.952381,199.3292323,6300
ISAT.JK,2022-01-07,6300,6350,6225,6300,6082.950684,5461600,125,0,6189.285714,5985.714286,6121.428571,177.8676608,6200
ISAT.JK,2022-01-10,6300,6325,6150,6200,5986.395996,4417000,175,-100,6253.571429,6003.571429,6086.904762,98.34947406,5950
ISAT.JK,2022-01-11,6200,6275,5900,5950,5745.009277,5822400,375,-250,6260.714286,6023.214286,6070.238095,91.12393444,5950
ISAT.JK,2022-01-12,5950,6050,5850,5950,5745.009277,5495700,200,0,6225,6032.142857,6055.952381,149.3039406,5850
ISAT.JK,2022-01-13,5950,6000,5850,5850,5648.454102,2177800,150,-100,6157.142857,6053.571429,6036.904762,151.1857892,6050
ISAT.JK,2022-01-14,5875,6150,5875,6050,5841.563965,4162400,275,175,6100,6071.428571,6016.666667,182.5741858,5950
ISAT.JK,2022-01-17,6075,6100,5925,5950,5745.009277,1908800,175,-125,6085.714286,6108.928571,6009.52381,181.9209666,5900
ISAT.JK,2022-01-18,6000,6025,5800,5900,5696.731445,2256000,225,-100,6035.714286,6112.5,6002.380952,159.9851184,5800
ISAT.JK,2022-01-19,5875,5975,5800,5800,5600.176758,3140000,175,-75,5978.571429,6116.071429,5995.238095,114.9534067,5975
ISAT.JK,2022-01-20,5800,6000,5800,5975,5769.147949,2216900,200,175,5921.428571,6091.071429,5989.285714,80.91735937,6000
ISAT.JK,2022-01-21,5975,6050,5900,6000,5793.286621,2248200,150,25,5925,6075,5996.428571,82.91561976,5975
ISAT.JK,2022-01-24,6100,6125,5950,5975,5769.147949,3392500,175,-125,5932.142857,6044.642857,6013.095238,87.45747266,5900
ISAT.JK,2022-01-25,5975,5975,5800,5900,5696.731445,3211600,175,-75,5950,6025,6030.952381,80.36375634,5950
ISAT.JK,2022-01-26,5900,6000,5850,5950,5745.009277,1658500,150,50,5928.571429,6007.142857,6048.809524,68.35655819,5875
ISAT.JK,2022-01-27,5950,6000,5850,5875,5672.592773,952000,150,-75,5928.571429,5982.142857,6051.190476,68.35655819,5850
ISAT.JK,2022-01-28,5900,5925,5825,5850,5648.454102,1543100,100,-50,5925,5951.785714,6052.380952,70.71067812,5725
ISAT.JK,2022-01-31,5850,5875,5625,5725,5527.760742,3523800,250,-125,5932.142857,5926.785714,6038.095238,57.21721353,5700
ISAT.JK,2022-02-02,5725,5800,5700,5700,5503.62207,2788000,100,-25,5896.428571,5910.714286,6015.47619,92.90291912,5700
ISAT.JK,2022-02-03,5725,5725,5550,5700,5503.62207,8024300,175,-25,5853.571429,5892.857143,5980.952381,105.5033288,5625
ISAT.JK,2022-02-04,5700,5725,5600,5625,5431.206055,3160400,125,-75,5814.285714,5882.142857,5954.761905,103.9402301,5675
ISAT.JK,2022-02-07,5625,5725,5575,5675,5479.483398,3152600,150,50,5775,5851.785714,5929.761905,117.260394,5575
ISAT.JK,2022-02-08,5725,5750,5525,5575,5382.928711,5770300,225,-150,5735.714286,5832.142857,5900,92.25998462,5525
ISAT.JK,2022-02-09,5575,5625,5500,5525,5334.651367,4953300,125,-50,5692.857143,5808.928571,5865.47619,86.25819492,5650
ISAT.JK,2022-02-10,5525,5675,5525,5650,5455.344727,4207300,150,125,5646.428571,5789.285714,5833.333333,74.20210496,5600
ISAT.JK,2022-02-11,5650,5650,5575,5600,5407.067383,3133500,75,-50,5635.714286,5766.071429,5819.047619,65.91842,5450
ISAT.JK,2022-02-14,5600,5675,5400,5450,5262.235352,3833900,275,-150,5621.428571,5737.5,5802.380952,60.25738445,5500
ISAT.JK,2022-02-15,5450,5500,5400,5500,5310.512695,3403600,100,50,5585.714286,5700,5783.333333,77.53647375,5575
ISAT.JK,2022-02-16,5600,5625,5475,5575,5382.928711,3769700,150,-25,5567.857143,5671.428571,5757.142857,81.28433341,5475
ISAT.JK,2022-02-17,5575,5600,5450,5475,5286.374023,3284200,150,-100,5553.571429,5644.642857,5739.285714,66.81531048,5550
ISAT.JK,2022-02-18,5475,5575,5450,5550,5358.790039,3229300,125,75,5539.285714,5616.071429,5719.047619,71.96229171,5500
ISAT.JK,2022-02-21,5550,5625,5500,5500,5310.512695,1825200,125,-50,5542.857143,5594.642857,5707.142857,71.75520555,5825
ISAT.JK,2022-02-22,5525,5850,5525,5825,5624.31543,12360600,325,300,5521.428571,5578.571429,5684.52381,54.82656638,5575
ISAT.JK,2022-02-23,5875,5900,5550,5575,5382.928711,10486500,350,-300,5553.571429,5587.5,5676.190476,127.0076863,5500
ISAT.JK,2022-02-24,5600,5725,5450,5500,5310.512695,8146100,275,-100,5571.428571,5578.571429,5657.142857,118.522652,5475
ISAT.JK,2022-02-25,5550,5550,5475,5475,5286.374023,4093800,75,-75,5571.428571,5569.642857,5638.095238,118.522652,5525
ISAT.JK,2022-03-01,5500,5550,5475,5525,5334.651367,2787300,75,25,5557.142857,5555.357143,5615.47619,123.9239398,5400
ISAT.JK,2022-03-02,5525,5525,5400,5400,5213.958008,5625800,125,-125,5564.285714,5551.785714,5598.809524,119.7716081,5400
ISAT.JK,2022-03-04,5425,5425,5150,5400,5213.958008,9224600,275,-25,5542.857143,5542.857143,5577.380952,135.1806551,5225
ISAT.JK,2022-03-07,5500,5500,5200,5225,5044.986816,2308100,300,-275,5528.571429,5525,5561.904762,145.3648939,5075
ISAT.JK,2022-03-08,5250,5325,5000,5075,4900.154785,4838900,325,-175,5442.857143,5498.214286,5539.285714,115.2120199,5275
ISAT.JK,2022-03-09,5150,5325,5050,5275,5093.26416,2892700,275,125,5371.428571,5471.428571,5509.52381,164.2080562,5350
ISAT.JK,2022-03-10,5350,5450,5225,5350,5165.680176,3978800,225,0,5339.285714,5455.357143,5492.857143,156.6957926,5300
ISAT.JK,2022-03-11,5375,5375,5250,5300,5117.402832,2650500,125,-75,5321.428571,5439.285714,5477.380952,145.3648939,5325
ISAT.JK,2022-03-14,5300,5350,5275,5325,5141.541504,2048100,75,25,5289.285714,5426.785714,5464.285714,114.4344271,5225
ISAT.JK,2022-03-15,5250,5350,5150,5225,5044.986816,1407600,200,-25,5278.571429,5410.714286,5454.761905,105.5033288,5200
ISAT.JK,2022-03-16,5225,5300,5175,5200,5020.848145,2362200,125,-25,5253.571429,5391.071429,5434.52381,91.77482796,5200
ISAT.JK,2022-03-17,5200,5250,5175,5200,5020.848145,1791400,75,0,5250,5346.428571,5415.47619,93.54143467,5300
ISAT.JK,2022-03-18,5225,5300,5200,5300,5117.402832,2533300,100,75,5267.857143,5319.642857,5403.571429,60.74928963,5375
ISAT.JK,2022-03-21,5325,5375,5225,5375,5189.819336,3164800,150,50,5271.428571,5305.357143,5394.047619,61.9619699,5250
ISAT.JK,2022-03-22,5375,5400,5250,5250,5069.125488,1975900,150,-125,5275,5298.214286,5384.52381,67.70032004,5300
ISAT.JK,2022-03-23,5300,5400,5250,5300,5117.402832,3007000,150,0,5267.857143,5278.571429,5373.809524,67.25927091,5325
ISAT.JK,2022-03-24,5350,5375,5275,5325,5141.541504,4109900,100,-25,5264.285714,5271.428571,5361.904762,64.31877457,5250
ISAT.JK,2022-03-25,5325,5350,5200,5250,5069.125488,1321100,150,-75,5278.571429,5266.071429,5353.571429,65.23766076,5225
ISAT.JK,2022-03-28,5300,5350,5225,5225,5044.986816,1998900,125,-75,5285.714286,5267.857143,5326.190476,57.47670336,5275
ISAT.JK,2022-03-29,5225,5300,5200,5275,5093.26416,2233400,100,50,5289.285714,5278.571429,5309.52381,51.75491695,5225
ISAT.JK,2022-03-30,5275,5275,5200,5225,5044.986816,808400,75,-50,5285.714286,5278.571429,5298.809524,51.75491695,5175
ISAT.JK,2022-03-31,5225,5275,5150,5175,4996.709473,1771200,125,-50,5264.285714,5269.642857,5286.904762,37.7964473,5200
ISAT.JK,2022-04-01,5200,5225,5150,5200,5020.848145,1583900,75,0,5253.571429,5260.714286,5270.238095,50.88502446,5175
ISAT.JK,2022-04-04,5200,5250,5150,5175,4996.709473,1169000,100,-25,5239.285714,5251.785714,5260.714286,49.70148987,5275
ISAT.JK,2022-04-05,5175,5300,5175,5275,5093.26416,2429200,125,100,5217.857143,5248.214286,5250,37.40066208,5150
ISAT.JK,2022-04-06,5275,5300,5125,5150,4972.570801,3338700,175,-125,5221.428571,5253.571429,5252.380952,41.90408549,5150
ISAT.JK,2022-04-07,5150,5200,5125,5150,4972.570801,1375400,75,0,5210.714286,5250,5255.952381,49.70148987,5325
ISAT.JK,2022-04-08,5150,5325,5150,5325,5141.541504,2742300,175,175,5192.857143,5239.285714,5250,44.98677054,5225
ISAT.JK,2022-04-11,5350,5400,5200,5225,5044.986816,4354400,200,-125,5207.142857,5235.714286,5248.809524,67.25927091,5200
ISAT.JK,2022-04-12,5225,5250,5150,5200,5020.848145,1179900,100,-25,5214.285714,5233.928571,5245.238095,65.91842,5300
ISAT.JK,2022-04-13,5225,5375,5200,5300,5117.402832,5014200,175,75,5214.285714,5226.785714,5239.285714,65.91842,5225
ISAT.JK,2022-04-14,5350,5400,5200,5225,5044.986816,4340300,200,-125,5232.142857,5225,5242.857143,70.28852104,5525
ISAT.JK,2022-04-18,5275,5600,5175,5525,5334.651367,13005000,425,250,5225,5223.214286,5244.047619,67.70032004,6150
ISAT.JK,2022-04-19,5575,6275,5550,6150,5938.118652,35621100,725,575,5278.571429,5244.642857,5259.52381,123.683544,7125
ISAT.JK,2022-04-20,6250,7325,6150,7125,6879.527832,53997100,1175,875,5421.428571,5307.142857,5300,339.555031,7025
ISAT.JK,2022-04-21,7125,7175,6700,7025,6782.972656,22227700,475,-100,5678.571429,5442.857143,5383.333333,721.3165873,7025
ISAT.JK,2022-04-22,7025,7400,7025,7025,6782.972656,11365800,375,0,5935.714286,5575,5467.857143,843.2152185,7175
ISAT.JK,2022-04-25,7000,7225,6800,7175,6927.805176,9687400,425,175,6196.428571,5705.357143,5550,859.799949,7100
ISAT.JK,2022-04-26,7200,7300,7075,7100,6855.38916,4250200,225,-100,6464.285714,5848.214286,5638.095238,825.3606715,7125
ISAT.JK,2022-04-27,7075,7300,7000,7125,6879.527832,5338900,300,50,6732.142857,5978.571429,5726.190476,639.4519603,7000
ISAT.JK,2022-04-28,7125,7150,6950,7000,6758.833984,8151800,200,-125,6960.714286,6119.642857,5816.666667,361.6677639,6525
ISAT.JK,2022-05-09,6975,6975,6525,6525,6300.199219,5976000,450,-450,7082.142857,6251.785714,5898.809524,65.6922841,6075
ISAT.JK,2022-05-10,6400,6450,6075,6075,5865.702637,4130200,375,-325,6996.428571,6337.5,5960.714286,217.1925852,6000
ISAT.JK,2022-05-11,6000,6250,5725,6000,5793.286621,11105900,525,0,6860.714286,6398.214286,6003.571429,408.7218754,5750
ISAT.JK,2022-05-12,6025,6050,5725,5750,5551.899414,4901800,325,-275,6714.285714,6455.357143,6041.666667,510.893242,5900
ISAT.JK,2022-05-13,5775,5950,5525,5900,5696.731445,7348700,425,125,6510.714286,6487.5,6069.047619,576.421638,6000
ISAT.JK,2022-05-17,5900,6200,5700,6000,5793.286621,5882300,500,100,6339.285714,6535.714286,6098.809524,549.7835072,5650
ISAT.JK,2022-05-18,6025,6025,5625,5650,5455.344727,9724500,400,-375,6178.571429,6569.642857,6139.285714,434.0767433,5550
ISAT.JK,2022-05-19,5650,5750,5550,5550,5358.790039,4598000,200,-100,5985.714286,6533.928571,6163.095238,281.3128237,5650
ISAT.JK,2022-05-20,5550,5750,5550,5650,5455.344727,4620600,200,100,5846.428571,6421.428571,6173.809524,199.1798661,5275
ISAT.JK,2022-05-23,5650,5700,5275,5275,5093.26416,9649500,425,-375,5785.714286,6323.214286,6194.047619,181.9209666,5275
ISAT.JK,2022-05-24,5275,5425,5275,5275,5093.26416,4224500,150,0,5682.142857,6198.214286,6197.619048,237.4843353,5250
ISAT.JK,2022-05-25,5300,5400,5250,5250,5069.125488,4566700,150,-50,5614.285714,6062.5,6196.428571,279.0822545,5425
ISAT.JK,2022-05-27,5300,5475,5200,5425,5238.09668,6432400,275,125,5521.428571,5930.357143,6197.619048,276.2956491,5375
ISAT.JK,2022-05-30,5475,5550,5325,5375,5189.819336,4915600,225,-100,5439.285714,5808.928571,6192.857143,178.4523412,5325
ISAT.JK,2022-05-31,5400,5550,5325,5325,5141.541504,28965900,225,-75,5400,5692.857143,6155.952381,152.7525232,5800
ISAT.JK,2022-06-02,5400,5850,5350,5800,5600.176758,12851300,500,400,5367.857143,5607.142857,6070.238095,138.9801288,5825
ISAT.JK,2022-06-03,5850,6100,5725,5825,5624.31543,12946800,375,-25,5389.285714,5587.5,6011.904762,191.4076925,5500
ISAT.JK,2022-06-06,5800,5875,5425,5500,5310.512695,13133700,450,-300,5467.857143,5575,5954.761905,242.6907693,5475
ISAT.JK,2022-06-07,5525,5575,5350,5475,5286.374023,5621700,225,-50,5500,5557.142857,5875,227.3030283,6200
ISAT.JK,2022-06-08,5500,6250,5500,6200,5986.395996,17995500,750,700,5532.142857,5526.785714,5797.619048,200.3716784,6425
ISAT.JK,2022-06-09,6200,6650,6025,6425,6203.644043,25404900,625,225,5642.857143,5541.071429,5753.571429,313.486538,6625
ISAT.JK,2022-06-10,6425,6625,6175,6625,6396.753906,8912200,450,200,5792.857143,5596.428571,5726.190476,402.5218125,6500
ISAT.JK,2022-06-13,6625,6625,6225,6500,6276.060547,10735700,400,-125,5978.571429,5673.214286,5730.952381,448.0114794,6750
ISAT.JK,2022-06-14,6450,7000,6375,6750,6517.447266,20562500,625,300,6078.571429,5733.928571,5751.190476,478.5891965,6700
ISAT.JK,2022-06-15,6775,6900,6625,6700,6469.169922,7015500,275,-75,6210.714286,5839.285714,5786.904762,522.5851491,6875
ISAT.JK,2022-06-16,6800,7025,6750,6875,6638.140625,7584100,275,75,6382.142857,5941.071429,5832.142857,441.0485342,6400
ISAT.JK,2022-06-17,6800,6825,6400,6400,6179.505371,16257000,425,-400,6582.142857,6057.142857,5878.571429,226.2531242,6250
ISAT.JK,2022-06-20,6350,6475,6050,6250,6034.67334,6836200,425,-100,6610.714286,6126.785714,5897.619048,177.2810521,6650
ISAT.JK,2022-06-21,6300,6750,6300,6650,6420.892578,10316500,450,350,6585.714286,6189.285714,5926.190476,215.9557935,6600
ISAT.JK,2022-06-22,6650,6750,6325,6600,6372.615234,5623000,425,-50,6589.285714,6283.928571,5978.571429,216.918352,6625
ISAT.JK,2022-06-23,6600,6650,6450,6625,6396.753906,3232800,200,25,6603.571429,6341.071429,6023.809524,213.3212422,6625
ISAT.JK,2022-06-24,6625,6900,6625,6625,6396.753906,5156600,275,0,6585.714286,6398.214286,6088.095238,204.0512307,6625
ISAT.JK,2022-06-27,6700,6775,6475,6625,6396.753906,2730700,300,-75,6575,6478.571429,6152.380952,198.9556064,6800
ISAT.JK,2022-06-28,6625,6800,6575,6800,6565.724609,3230500,225,175,6539.285714,6560.714286,6217.857143,153.3359213,6750
ISAT.JK,2022-06-29,6800,6850,6625,6750,6517.447266,5421900,225,-50,6596.428571,6603.571429,6283.333333,166.7261799,6550
ISAT.JK,2022-06-30,6750,6900,6400,6550,6324.337891,4318800,500,-200,6667.857143,6626.785714,6348.809524,75.98558761,6325
ISAT.JK,2022-07-01,6500,6575,6250,6325,6107.089355,1938900,325,-175,6653.571429,6621.428571,6407.142857,88.30412815,6250
ISAT.JK,2022-07-04,6325,6375,5975,6250,6034.67334,4873000,400,-75,6614.285714,6608.928571,6432.142857,153.3359213,6275
ISAT.JK,2022-07-05,6375,6375,6200,6275,6058.812012,2432100,175,-100,6560.714286,6573.214286,6452.380952,205.5770045,6400
ISAT.JK,2022-07-06,6300,6475,6150,6400,6179.505371,5501900,325,100,6510.714286,6542.857143,6489.285714,228.6086279,6450
ISAT.JK,2022-07-07,6375,6525,6300,6450,6227.782715,3584900,225,75,6478.571429,6508.928571,6533.333333,225.6604065,6325
ISAT.JK,2022-07-08,6475,6550,6325,6325,6107.089355,2119700,225,-150,6428.571429,6512.5,6545.238095,175.8482842,6400
ISAT.JK,2022-07-11,6325,6450,6300,6400,6179.505371,2253300,150,75,6367.857143,6517.857143,6540.47619,105.7850471,6500
ISAT.JK,2022-07-12,6400,6550,6325,6500,6276.060547,1260400,225,100,6346.428571,6500,6529.761905,72.78474461,6350
ISAT.JK,2022-07-13,6500,6500,6225,6350,6131.228027,4719600,275,-150,6371.428571,6492.857143,6529.761905,91.77482796,6225
ISAT.JK,2022-07-14,6325,6375,6175,6225,6010.534668,1302600,200,-100,6385.714286,6473.214286,6510.714286,76.18117503,6100
ISAT.JK,2022-07-15,6225,6275,6050,6100,5889.841309,3810700,225,-125,6378.571429,6444.642857,6488.095238,89.47598773,6075
ISAT.JK,2022-07-18,6100,6175,5950,6075,5865.702637,2914300,225,-25,6335.714286,6407.142857,6451.190476,136.8219211,6225
ISAT.JK,2022-07-19,6075,6350,6050,6225,6010.534668,4638900,300,150,6282.142857,6355.357143,6435.714286,156.6007967,6400
ISAT.JK,2022-07-20,6300,6475,6250,6400,6179.505371,11713200,225,100,6267.857143,6317.857143,6434.52381,156.6007967,6500
ISAT.JK,2022-07-21,6275,6650,6275,6500,6276.060547,6167000,375,225,6267.857143,6307.142857,6422.619048,156.6007967,6450
ISAT.JK,2022-07-22,6500,6575,6300,6450,6227.782715,3323500,275,-50,6267.857143,6319.642857,6417.857143,156.6007967,6550
ISAT.JK,2022-07-25,6425,6575,6425,6550,6324.337891,2701400,150,125,6282.142857,6333.928571,6409.52381,169.3826325,6325
ISAT.JK,2022-07-26,6550,6625,6300,6325,6107.089355,9470300,325,-225,6328.571429,6353.571429,6405.952381,193.879565,6500
ISAT.JK,2022-07-27,6300,6525,6200,6500,6276.060547,4510700,325,200,6360.714286,6348.214286,6391.666667,166.3687814,6525
ISAT.JK,2022-07-28,6525,6600,6375,6525,6300.199219,6387000,225,0,6421.428571,6351.785714,6377.380952,114.0436424,6675
ISAT.JK,2022-07-29,6525,6825,6450,6675,6445.03125,5066100,375,150,6464.285714,6366.071429,6366.666667,78.86848607,6775
ISAT.JK,2022-08-01,6675,6975,6675,6775,6541.585938,12650000,300,100,6503.571429,6385.714286,6372.619048,105.5033288,6800
ISAT.JK,2022-08-02,6750,7025,6725,6800,6565.724609,12457600,300,50,6542.857143,6405.357143,6394.047619,146.9936831,7200
ISAT.JK,2022-08-03,6875,7275,6800,7200,6951.943848,15624200,475,325,6592.857143,6437.5,6420.238095,168.1481773,7150
ISAT.JK,2022-08-04,7300,7300,7050,7150,6903.666504,7186200,250,-150,6685.714286,6507.142857,6464.285714,281.6828679,7200
ISAT.JK,2022-08-05,7150,7250,7100,7200,6951.943848,6315400,150,50,6803.571429,6582.142857,6500,278.1743201,7200
ISAT.JK,2022-08-08,7250,7425,7025,7200,6951.943848,6661700,400,-50,6903.571429,6662.5,6535.714286,276.6724038,7100
ISAT.JK,2022-08-09,7225,7250,7075,7100,6855.38916,2758500,175,-125,7000,6732.142857,6577.380952,237.6096238,7125
ISAT.JK,2022-08-10,7100,7175,6825,7125,6879.527832,8438000,350,25,7060.714286,6782.142857,6610.714286,190.316153,7175
ISAT.JK,2022-08-11,7200,7275,7125,7175,6927.805176,14351400,150,-25,7110.714286,6826.785714,6640.47619,142.7827187,7350
ISAT.JK,2022-08-12,7175,7500,7175,7350,7096.775879,9376100,325,175,7164.285714,6878.571429,6679.761905,40.45867969,7325
ISAT.JK,2022-08-15,7400,7525,7200,7325,7072.637207,8211300,325,-75,7185.714286,6935.714286,6733.333333,81.46720053,7325
ISAT.JK,2022-08-16,7325,7450,7250,7325,7072.637207,4843600,200,0,7210.714286,7007.142857,6791.666667,94.49111825,7325
ISAT.JK,2022-08-18,7325,7425,7200,7325,7072.637207,5153300,225,0,7228.571429,7066.071429,6851.190476,103.5098339,7525
ISAT.JK,2022-08-19,7500,7525,7375,7525,7265.746582,8041900,150,25,7246.428571,7123.214286,6903.571429,108.4248698,7200
ISAT.JK,2022-08-22,7550,7625,7075,7200,6951.943848,8215200,550,-350,7307.142857,7183.928571,6957.142857,129.6745009,7250
ISAT.JK,2022-08-23,7200,7325,7200,7250,7000.221191,7491800,125,50,7317.857143,7214.285714,6990.47619,114.304314,7225
ISAT.JK,2022-08-24,7300,7300,7150,7225,6976.08252,3732200,150,-75,7328.571429,7246.428571,7028.571429,101.4771849,7225
ISAT.JK,2022-08-25,7250,7300,7200,7225,6976.08252,5247700,100,-25,7310.714286,7248.214286,7060.714286,107.8744861,7200
ISAT.JK,2022-08-26,7225,7300,7200,7200,6951.943848,5522800,100,-25,7296.428571,7253.571429,7103.571429,112.2019862,7000
ISAT.JK,2022-08-29,6950,7200,6800,7000,7000,3259700,400,50,7278.571429,7253.571429,7136.904762,116.7516697,7225
ISAT.JK,2022-08-30,7000,7250,6975,7225,7225,7202000,275,225,7232.142857,7239.285714,7159.52381,153.9171082,7175
ISAT.JK,2022-08-31,7225,7300,7000,7175,7175,2943400,300,-50,7189.285714,7248.214286,7185.714286,85.21681032,7125
ISAT.JK,2022-09-01,7400,7400,7050,7125,7125,1328400,350,-275,7185.714286,7251.785714,7204.761905,85.21681032,7075
ISAT.JK,2022-09-02,7125,7125,6975,7075,7075,1721000,150,-50,7167.857143,7248.214286,7220.238095,82.55589737,7100
ISAT.JK,2022-09-05,7075,7125,6900,7100,7100,6546900,225,25,7146.428571,7228.571429,7214.285714,84.69131625,7200
ISAT.JK,2022-09-06,7125,7250,7075,7200,7200,12572900,175,75,7128.571429,7212.5,7211.904762,78.30039834,6950
ISAT.JK,2022-09-07,7200,7200,6950,6950,6950,3905300,250,-250,7128.571429,7203.571429,7211.904762,78.30039834,7200
ISAT.JK,2022-09-08,6975,7275,6975,7200,7200,8067100,300,225,7121.428571,7176.785714,7200,92.90291912,7175
ISAT.JK,2022-09-09,7200,7250,7150,7175,7175,13500100,100,-25,7117.857143,7153.571429,7204.761905,88.64052604,7200
ISAT.JK,2022-09-12,7175,7275,7100,7200,7200,19056100,175,25,7117.857143,7151.785714,7207.142857,88.64052604,7300
ISAT.JK,2022-09-13,7200,7400,7150,7300,7300,6668000,250,100,7128.571429,7148.214286,7208.333333,94.01747558,7125
ISAT.JK,2022-09-14,7200,7275,7000,7125,7125,3429700,275,-75,7160.714286,7153.571429,7205.952381,109.7887582,7175
ISAT.JK,2022-09-15,7125,7325,7075,7175,7175,6510600,250,50,7164.285714,7146.428571,7196.428571,107.8744861,7050
ISAT.JK,2022-09-16,7175,7200,6975,7050,7050,15183100,225,-125,7160.714286,7144.642857,7189.285714,106.9044968,0