TICKER;Date;Open;High;Low;Close;Adj Close;Volume;H-L;C-O;7 DAYS MA;14 DAYS MA;21 DAYS MA;7 DAYS STD DEV;NEXT DAY CLOSE
TLKM.JK;18/09/18;3470;3590;3440;3570;3077.475586;132571400;150;100;0;0;0;0;3550
TLKM.JK;19/09/18;3580;3610;3540;3550;3060.234619;88139600;70;-30;0;0;0;0;3600
TLKM.JK;20/09/18;3590;3640;3570;3600;3103.33667;80194400;70;10;0;0;0;0;3600
TLKM.JK;21/09/18;3630;3630;3550;3600;3103.33667;98577800;80;-30;0;0;0;0;3540
TLKM.JK;24/09/18;3590;3600;3510;3540;3051.614258;48101000;90;-50;0;0;0;0;3560
TLKM.JK;25/09/18;3540;3560;3520;3560;3068.855225;25350200;40;20;0;0;0;0;3540
TLKM.JK;26/09/18;3550;3590;3540;3540;3051.614258;51055900;50;-10;0;0;0;0;3580
TLKM.JK;27/09/18;3580;3590;3550;3580;3086.095703;49549400;40;0;3565.714286;0;0;25.72750983;3640
TLKM.JK;28/09/18;3600;3670;3600;3640;3137.818359;116695900;70;40;3567.142857;0;0;26.27691364;3670
TLKM.JK;01/10/18;3610;3690;3610;3670;3163.679199;45504900;80;60;3580;0;0;36.51483717;3620
TLKM.JK;02/10/18;3640;3670;3580;3620;3120.577148;61393800;90;-20;3590;0;0;50;3600
TLKM.JK;03/10/18;3570;3640;3570;3600;3103.33667;46611900;70;30;3592.857143;0;0;51.22313465;3600
TLKM.JK;04/10/18;3570;3600;3510;3600;3103.33667;82550500;90;30;3601.428571;0;0;45.61745698;3530
TLKM.JK;05/10/18;3540;3600;3530;3530;3042.994141;59270300;70;-10;3607.142857;0;0;41.91828786;3520
TLKM.JK;08/10/18;3500;3530;3470;3520;3034.373535;71886100;60;20;3605.714286;3585.714286;0;44.66808811;3590
TLKM.JK;09/10/18;3530;3620;3520;3590;3094.716309;58708100;100;60;3597.142857;3582.142857;0;54.98917642;3600
TLKM.JK;10/10/18;3640;3640;3560;3600;3103.33667;31937500;80;-40;3590;3585;0;51.63977795;3570
TLKM.JK;11/10/18;3500;3640;3480;3570;3077.475586;114418300;160;70;3580;3585;0;38.72983346;3680
TLKM.JK;12/10/18;3630;3700;3620;3680;3172.299805;87991200;80;50;3572.857143;3582.857143;0;34.50327797;3660
TLKM.JK;15/10/18;3700;3750;3650;3660;3155.058594;68466400;100;-40;3584.285714;3592.857143;0;53.18431563;3780
TLKM.JK;16/10/18;3680;3780;3680;3780;3258.503418;98103600;100;100;3592.857143;3600;0;60.47431568;3900
TLKM.JK;17/10/18;3800;3910;3800;3900;3361.947998;122953700;110;100;3628.571429;3617.142857;3600;85.71825388;3760
TLKM.JK;18/10/18;3840;3880;3720;3760;3241.262451;102322600;160;-80;3682.857143;3640;3615.714286;119.2636136;3730
TLKM.JK;19/10/18;3700;3770;3690;3730;3215.401611;140162100;80;30;3707.142857;3648.571429;3625.714286;114.4136189;3800
TLKM.JK;22/10/18;3730;3830;3730;3800;3275.743896;57680500;100;70;3725.714286;3652.857143;3631.904762;104.2204623;3700
TLKM.JK;23/10/18;3800;3800;3670;3700;3189.540283;53266800;130;-100;3758.571429;3665.714286;3641.428571;80.5043625;3520
TLKM.JK;24/10/18;3700;3710;3520;3520;3034.373535;117672200;190;-180;3761.428571;3672.857143;3649.047619;77.55182599;3550
TLKM.JK;25/10/18;3490;3580;3460;3550;3060.234619;120108900;120;60;3741.428571;3667.142857;3647.142857;116.3942398;3630
TLKM.JK;26/10/18;3580;3660;3580;3630;3129.197754;100554100;80;50;3708.571429;3668.571429;3647.619048;134.713099;3660
TLKM.JK;29/10/18;3630;3660;3580;3660;3155.058594;54304000;80;30;3670;3676.428571;3650;106.4581295;3800
TLKM.JK;30/10/18;3640;3850;3630;3800;3275.743896;158933000;220;160;3655.714286;3681.428571;3650.952381;98.80235201;3850
TLKM.JK;31/10/18;3850;3870;3730;3850;3318.845947;140351400;140;0;3665.714286;3695.714286;3657.142857;110.4320519;3880
TLKM.JK;01/11/18;3850;3880;3810;3880;3344.707275;69586900;70;30;3672.857143;3715.714286;3668.095238;121.6161017;3940
TLKM.JK;02/11/18;3900;3940;3880;3940;3396.429443;98072700;60;40;3698.571429;3730;3681.428571;145.0779757;3890
TLKM.JK;05/11/18;3850;3910;3850;3890;3353.327637;60121700;60;40;3758.571429;3750;3697.619048;145.7656305;3890
TLKM.JK;06/11/18;3930;3930;3820;3890;3353.327637;58088000;110;-40;3807.142857;3757.857143;3714.761905;118.8436348;3950
TLKM.JK;07/11/18;3900;3950;3870;3950;3405.049561;98350100;80;50;3844.285714;3757.142857;3732.380952;91.8072515;4000
TLKM.JK;08/11/18;3970;4000;3920;4000;3448.151611;74004300;80;30;3885.714286;3770.714286;3749.52381;51.26959556;3920
TLKM.JK;09/11/18;3960;3960;3920;3920;3379.188721;45243300;40;-40;3914.285714;3790;3768.571429;51.26959556;3860
TLKM.JK;12/11/18;3890;3950;3860;3860;3327.466553;57256000;90;-30;3924.285714;3798.571429;3785.238095;42.76179871;3830
TLKM.JK;13/11/18;3810;3850;3750;3830;3301.605225;89819400;100;20;3921.428571;3810;3793.809524;46.70066789;3750
TLKM.JK;14/11/18;3860;3880;3750;3750;3232.642334;72968500;130;-110;3905.714286;3832.142857;3801.904762;56.82051943;3910
TLKM.JK;15/11/18;3800;3940;3790;3910;3370.568115;71440400;150;110;3885.714286;3846.428571;3800.47619;82.23080178;4050
TLKM.JK;16/11/18;3930;4110;3920;4050;3491.253662;128595600;190;120;3888.571429;3866.428571;3800.952381;82.75034168;3950
TLKM.JK;19/11/18;4050;4050;3930;3950;3405.049561;72785900;120;-100;3902.857143;3894.285714;3814.761905;101.606149;3950
TLKM.JK;20/11/18;3950;3950;3950;3950;3405.049561;0;0;0;3895.714286;3905;3825.238095;95.19403743;3960
TLKM.JK;21/11/18;3860;3960;3850;3960;3413.670166;97525800;110;100;3900;3912.142857;3832.380952;97.12534856;3980
TLKM.JK;22/11/18;3910;3990;3910;3980;3430.911133;52279900;80;70;3914.285714;3917.857143;3844.761905;97.61440175;3990
TLKM.JK;23/11/18;3980;4000;3950;3990;3439.53125;35499400;50;10;3935.714286;3920.714286;3866.666667;92.35026491;3990
TLKM.JK;26/11/18;3980;4000;3950;3990;3439.53125;43879100;50;10;3970;3927.857143;3887.619048;43.58898944;3880
TLKM.JK;27/11/18;3940;3950;3850;3880;3344.707275;116422400;100;-60;3981.428571;3935;3904.761905;34.84660262;3720
TLKM.JK;28/11/18;3890;3900;3710;3720;3206.781006;195860500;190;-170;3957.142857;3930;3915.238095;38.17254062;3740
TLKM.JK;29/11/18;3770;3810;3710;3740;3224.021973;120921500;100;-30;3924.285714;3910;3911.428571;97.78499252;3680
TLKM.JK;30/11/18;3760;3780;3680;3680;3172.299805;151545800;100;-80;3894.285714;3897.142857;3906.190476;118.5829025;3700
TLKM.JK;03/12/18;3740;3770;3700;3700;3189.540283;106891000;70;-40;3854.285714;3884.285714;3896.666667;138.3060788;3780
TLKM.JK;04/12/18;3720;3780;3720;3780;3258.503418;121586400;60;60;3814.285714;3875;3885.238095;136.3643579;3770
TLKM.JK;05/12/18;3740;3800;3730;3770;3249.883057;58424400;70;30;3784.285714;3877.142857;3880;112.2285084;3710
TLKM.JK;06/12/18;3740;3770;3700;3710;3198.160645;62164100;70;-30;3752.857143;3867.142857;3874.285714;66.51172471;3670
TLKM.JK;07/12/18;3700;3710;3660;3670;3163.679199;92902000;50;-30;3728.571429;3842.857143;3862.857143;36.70993119;3680
TLKM.JK;10/12/18;3650;3720;3610;3680;3172.299805;70093700;110;30;3721.428571;3822.857143;3847.142857;42.98393941;3620
TLKM.JK;11/12/18;3640;3670;3610;3620;3120.577148;88050700;60;-20;3712.857143;3803.571429;3835.714286;44.61475306;3650
TLKM.JK;12/12/18;3660;3670;3620;3650;3146.438477;87333000;50;-10;3704.285714;3779.285714;3824.285714;56.23081683;3750
TLKM.JK;13/12/18;3680;3780;3660;3750;3232.642334;118965900;120;70;3697.142857;3755.714286;3815.714286;59.92058236;3730
TLKM.JK;14/12/18;3800;3840;3730;3730;3215.401611;139547100;110;-70;3692.857143;3738.571429;3815.714286;53.763149;3710
TLKM.JK;17/12/18;3740;3770;3710;3710;3198.160645;86251600;60;-30;3687.142857;3720;3807.142857;45.72172559;3740
TLKM.JK;18/12/18;3700;3740;3680;3740;3224.021973;79833100;60;40;3687.142857;3707.857143;3790.952381;45.72172559;3810
TLKM.JK;19/12/18;3740;3810;3740;3810;3284.364502;81542500;70;70;3697.142857;3709.285714;3780.952381;48.89249626;3740
TLKM.JK;20/12/18;3810;3810;3720;3740;3224.021973;100129200;90;-70;3715.714286;3714.285714;3774.285714;63.73307432;3760
TLKM.JK;21/12/18;3700;3770;3700;3760;3241.262451;114752300;70;60;3732.857143;3718.571429;3763.809524;47.85891965;3760
TLKM.JK;24/12/18;3760;3760;3760;3760;3241.262451;0;0;0;3748.571429;3722.857143;3753.333333;31.32015934;3760
TLKM.JK;25/12/18;3760;3760;3760;3760;3241.262451;0;0;0;3750;3721.428571;3742.380952;31.6227766;3730
TLKM.JK;26/12/18;3730;3750;3700;3730;3215.401611;50416400;50;0;3754.285714;3720.714286;3731.428571;30.47247001;3750
TLKM.JK;27/12/18;3780;3790;3730;3750;3232.642334;49980900;60;-30;3757.142857;3722.142857;3724.285714;26.27691364;3750
TLKM.JK;28/12/18;3770;3780;3750;3750;3232.642334;48224400;30;-20;3758.571429;3727.857143;3725.714286;25.44836041;3750
TLKM.JK;31/12/18;3750;3750;3750;3750;3232.642334;0;0;0;3750;3732.857143;3726.190476;11.54700538;3750
TLKM.JK;01/01/19;3750;3750;3750;3750;3232.642334;0;0;0;3751.428571;3742.142857;3729.52381;10.69044968;3730
TLKM.JK;02/01/19;3750;3760;3700;3730;3215.401611;31355300;60;-20;3750;3749.285714;3731.904762;10;3740
TLKM.JK;03/01/19;3710;3770;3690;3740;3224.021973;83842400;80;30;3745.714286;3747.857143;3729.52381;11.33893419;3710
TLKM.JK;04/01/19;3690;3740;3690;3710;3198.160645;73936900;50;20;3742.857143;3748.571429;3728.095238;9.511897312;3770
TLKM.JK;07/01/19;3760;3790;3750;3770;3249.883057;83678100;40;10;3740;3748.571429;3728.095238;15.27525232;3800
TLKM.JK;08/01/19;3770;3800;3750;3800;3275.743896;67963700;50;30;3742.857143;3750.714286;3732.857143;18.89822365;3730
TLKM.JK;09/01/19;3820;3830;3730;3730;3215.401611;98529400;100;-90;3750;3750;3738.571429;28.86751346;3800
TLKM.JK;10/01/19;3760;3800;3740;3800;3275.743896;126396700;60;40;3747.142857;3749.285714;3743.809524;29.84084768;3860
TLKM.JK;11/01/19;3820;3860;3800;3860;3327.466553;116753700;60;40;3754.285714;3752.142857;3750.952381;35.98941643;3850
TLKM.JK;14/01/19;3810;3850;3790;3850;3318.845947;68487000;60;40;3772.857143;3759.285714;3756.190476;51.54748158;3930
TLKM.JK;15/01/19;3860;3930;3850;3930;3387.809326;83464900;80;70;3788.571429;3765.714286;3761.904762;56.39993246;3990
TLKM.JK;16/01/19;3940;4000;3920;3990;3439.53125;139056700;80;50;3820;3780;3772.380952;65.82805886;3990
TLKM.JK;17/01/19;3970;3990;3960;3990;3439.53125;78766100;30;20;3851.428571;3797.142857;3784.285714;87.06866475;4020
TLKM.JK;18/01/19;4010;4020;3970;4020;3465.392578;76350400;50;10;3878.571429;3814.285714;3792.857143;97.3701822;4030
TLKM.JK;21/01/19;4040;4050;4020;4030;3474.012695;83317600;30;-10;3920;3833.571429;3806.190476;84.45906306;4000
TLKM.JK;22/01/19;4000;4010;3930;4000;3448.151611;95420500;80;0;3952.857143;3853.571429;3819.047619;74.09774754;3920
TLKM.JK;23/01/19;3950;3980;3920;3920;3379.188721;72518500;60;-30;3972.857143;3872.857143;3830.47619;62.9058253;3860
TLKM.JK;24/01/19;3900;3910;3830;3860;3327.466553;118836500;80;-40;3982.857143;3885.714286;3838.095238;42.31401884;3880
TLKM.JK;25/01/19;3880;3930;3840;3880;3344.707275;75844000;90;0;3972.857143;3896.428571;3844.285714;61.02302454;3780
TLKM.JK;28/01/19;3880;3890;3730;3780;3258.503418;168983100;160;-100;3957.142857;3904.285714;3850.47619;69.45365018;3840
TLKM.JK;29/01/19;3780;3850;3780;3840;3310.22583;118131200;70;60;3927.142857;3902.857143;3851.904762;93.93513466;3860
TLKM.JK;30/01/19;3850;3890;3830;3860;3327.466553;85903100;60;10;3901.428571;3910.714286;3856.190476;88.77472828;3900
TLKM.JK;31/01/19;3900;3920;3870;3900;3361.947998;110953700;50;0;3877.142857;3915;3861.428571;68.72997544;3870
TLKM.JK;01/02/19;3910;3930;3830;3870;3336.08667;79588900;100;-40;3862.857143;3917.857143;3869.52381;45.35573676;3780
TLKM.JK;04/02/19;3890;3890;3780;3780;3258.503418;70070500;110;-110;3855.714286;3919.285714;3875.714286;38.23486317;3780
TLKM.JK;05/02/19;3780;3780;3780;3780;3258.503418;0;0;0;3844.285714;3908.571429;3879.047619;47.55948656;3860
TLKM.JK;06/02/19;3820;3870;3820;3860;3327.466553;72180200;50;40;3830;3893.571429;3879.52381;50;3860
TLKM.JK;07/02/19;3890;3890;3830;3860;3327.466553;39141500;60;-30;3841.428571;3884.285714;3882.380952;45.61745698;3850
TLKM.JK;08/02/19;3810;3850;3810;3850;3318.845947;32131700;40;40;3844.285714;3872.857143;3888.571429;46.13644361;3930
TLKM.JK;11/02/19;3870;3940;3860;3930;3387.809326;88628900;80;60;3842.857143;3860;3890.952381;45.72172559;3820
TLKM.JK;12/02/19;3900;3910;3800;3820;3292.985107;92427800;110;-80;3847.142857;3855;3894.285714;52.82495803;3790
TLKM.JK;13/02/19;3840;3850;3780;3790;3267.124023;113161100;70;-50;3840;3847.857143;3892.857143;52.59911279;3740
TLKM.JK;14/02/19;3790;3810;3740;3740;3224.021973;76939400;70;-50;3841.428571;3842.857143;3886.190476;50.80307452;3790
TLKM.JK;15/02/19;3770;3800;3730;3790;3267.124023;67812600;70;20;3835.714286;3832.857143;3874.285714;60.23762469;3900
TLKM.JK;18/02/19;3830;3920;3830;3900;3361.947998;80275800;90;70;3825.714286;3833.571429;3864.761905;61.33436852;3920
TLKM.JK;19/02/19;3930;3940;3900;3920;3379.188721;82962700;40;-10;3831.428571;3837.857143;3859.047619;66.69047194;3870
TLKM.JK;20/02/19;3940;3940;3830;3870;3336.08667;87933000;110;-70;3841.428571;3842.142857;3853.809524;74.70577207;3870
TLKM.JK;21/02/19;3870;3890;3860;3870;3336.08667;48031100;30;0;3832.857143;3840;3847.619048;65.75568054;3840
TLKM.JK;22/02/19;3870;3870;3820;3840;3310.22583;61392700;50;-30;3840;3840;3845.238095;66.83312552;3910
TLKM.JK;25/02/19;3900;3920;3850;3910;3370.568115;53792400;70;10;3847.142857;3844.285714;3844.285714;63.17021601;3930
TLKM.JK;26/02/19;3920;3930;3880;3930;3387.809326;49657300;50;10;3871.428571;3853.571429;3845.714286;45.25062483;3910
TLKM.JK;27/02/19;3900;3940;3890;3910;3370.568115;48788200;50;10;3891.428571;3858.571429;3852.857143;32.36694375;3860
TLKM.JK;28/02/19;3880;3900;3840;3860;3327.466553;161156000;60;-20;3892.857143;3862.142857;3856.190476;33.02235895;3910
TLKM.JK;01/03/19;3890;3920;3880;3910;3370.568115;49810100;40;20;3884.285714;3862.857143;3856.190476;32.58688021;3850
TLKM.JK;04/03/19;3910;3910;3850;3850;3318.845947;32250500;60;-60;3890;3861.428571;3856.666667;33.1662479;3870
TLKM.JK;05/03/19;3890;3890;3820;3870;3336.08667;41171000;70;-20;3887.142857;3863.571429;3855.714286;35.9231985;3820
TLKM.JK;06/03/19;3860;3880;3820;3820;3292.985107;69927600;60;-40;3891.428571;3869.285714;3860;30.78342164;3820
TLKM.JK;07/03/19;3820;3820;3820;3820;3292.985107;0;0;0;3878.571429;3875;3861.904762;39.33978962;3740
TLKM.JK;08/03/19;3810;3820;3740;3740;3224.021973;105963500;80;-70;3862.857143;3877.142857;3860;37.28908943;3800
TLKM.JK;11/03/19;3780;3820;3760;3800;3275.743896;43971600;60;20;3838.571429;3865.714286;3854.285714;53.36308694;3760
TLKM.JK;12/03/19;3800;3820;3730;3760;3241.262451;43343700;90;-40;3830;3857.142857;3851.904762;54.16025603;3720
TLKM.JK;13/03/19;3730;3770;3710;3720;3206.781006;45607600;60;-10;3808.571429;3849.285714;3843.809524;46.3424109;3740
TLKM.JK;14/03/19;3720;3760;3710;3740;3224.021973;62094100;50;20;3790;3838.571429;3839.047619;52.59911279;3750
TLKM.JK;15/03/19;3720;3760;3710;3750;3232.642334;68778100;50;30;3771.428571;3831.428571;3836.666667;41.40393356;3820
TLKM.JK;18/03/19;3770;3820;3760;3820;3292.985107;44322600;60;50;3761.428571;3820;3837.142857;35.79039509;3780
TLKM.JK;19/03/19;3800;3820;3770;3780;3258.503418;33156500;50;-20;3761.428571;3812.142857;3838.571429;35.79039509;3760
TLKM.JK;20/03/19;3810;3820;3750;3760;3241.262451;42784600;70;-50;3767.142857;3802.857143;3832.857143;34.98298906;3790
TLKM.JK;21/03/19;3800;3810;3780;3790;3267.124023;36527500;30;-10;3761.428571;3795.714286;3825.238095;31.84785259;3800
TLKM.JK;22/03/19;3800;3820;3790;3800;3275.743896;26772900;30;0;3765.714286;3787.142857;3821.428571;33.59421719;3790
TLKM.JK;25/03/19;3730;3790;3720;3790;3267.124023;49162900;70;60;3777.142857;3783.571429;3818.095238;28.70208222;3820
TLKM.JK;26/03/19;3780;3820;3780;3820;3292.985107;23049100;40;40;3784.285714;3777.857143;3815.714286;23.70453041;3820
TLKM.JK;27/03/19;3840;3840;3810;3820;3292.985107;35521900;30;-20;3794.285714;3777.857143;3811.428571;21.49196971;3880
TLKM.JK;28/03/19;3820;3890;3810;3880;3344.707275;55847200;80;60;3794.285714;3777.857143;3806.190476;21.49196971;3960
TLKM.JK;29/03/19;3880;3970;3880;3960;3413.670166;82231400;90;80;3808.571429;3787.857143;3804.761905;37.60699023;3930
TLKM.JK;01/04/19;3950;3960;3900;3930;3387.809326;28246400;60;-20;3837.142857;3799.285714;3809.52381;62.37368187;3930
TLKM.JK;02/04/19;3910;3950;3910;3930;3387.809326;35443400;40;20;3857.142857;3811.428571;3810.47619;67.01101544;3930
TLKM.JK;03/04/19;3930;3930;3930;3930;3387.809326;0;0;0;3875.714286;3826.428571;3814.285714;66.54751256;4030
TLKM.JK;04/04/19;3980;4040;3950;4030;3474.012695;96122100;90;50;3895.714286;3840;3817.142857;56.82051943;4060
TLKM.JK;05/04/19;4020;4090;4000;4060;3499.874023;66832600;90;40;3925.714286;3860;3827.142857;65.02746672;3950
TLKM.JK;08/04/19;4020;4030;3940;3950;3405.049561;73208300;90;-70;3960;3877.142857;3838.571429;63.2455532;3950
TLKM.JK;09/04/19;3980;4000;3910;3950;3405.049561;88580200;90;-30;3970;3889.285714;3848.571429;53.22906474;3930
TLKM.JK;10/04/19;3920;3950;3890;3930;3387.809326;52555500;60;10;3968.571429;3902.857143;3855.714286;53.67450401;3890
TLKM.JK;11/04/19;3900;3930;3880;3890;3353.327637;51480700;50;-10;3968.571429;3912.857143;3863.809524;53.67450401;3830
TLKM.JK;12/04/19;3820;3870;3810;3830;3301.605225;45324300;60;10;3962.857143;3919.285714;3871.904762;60.19808572;3830
TLKM.JK;15/04/19;3860;3860;3810;3830;3301.605225;44510600;50;-30;3948.571429;3922.142857;3876.190476;78.40675384;3870
TLKM.JK;16/04/19;3830;3880;3830;3870;3336.08667;62572100;50;40;3920;3922.857143;3880;80.20806277;3870
TLKM.JK;17/04/19;3870;3870;3870;3870;3336.08667;0;0;0;3892.857143;3926.428571;3882.380952;52.19012861;3860
TLKM.JK;18/04/19;3920;3950;3840;3860;3327.466553;119263400;110;-60;3881.428571;3925.714286;3886.666667;45.98136268;3860
TLKM.JK;19/04/19;3860;3860;3860;3860;3327.466553;0;0;0;3868.571429;3918.571429;3891.428571;34.84660262;3780
TLKM.JK;22/04/19;3860;3860;3780;3780;3258.503418;48671200;80;-80;3858.571429;3913.571429;3894.761905;21.93062655;3850
TLKM.JK;23/04/19;3780;3870;3730;3850;3318.845947;86443700;140;70;3842.857143;3902.857143;3893.809524;32.51373336;3840
TLKM.JK;24/04/19;3850;3860;3780;3840;3310.22583;76660900;80;-10;3845.714286;3897.142857;3896.666667;32.07134903;3830
TLKM.JK;25/04/19;3800;3840;3790;3830;3301.605225;52775100;50;30;3847.142857;3883.571429;3897.619048;31.4718317;3910
TLKM.JK;26/04/19;3800;3910;3800;3910;3370.568115;66452700;110;110;3841.428571;3867.142857;3898.095238;30.23715784;3860
TLKM.JK;29/04/19;3850;3900;3850;3860;3327.466553;50143700;50;10;3847.142857;3864.285714;3899.52381;39.03600292;3790
TLKM.JK;30/04/19;3890;3890;3750;3790;3267.124023;132318200;140;-100;3847.142857;3857.857143;3894.761905;39.03600292;3790
TLKM.JK;01/05/19;3790;3790;3790;3790;3267.124023;0;0;0;3837.142857;3847.857143;3888.095238;43.8612531;3830
TLKM.JK;02/05/19;3760;3880;3760;3830;3301.605225;136768800;120;70;3838.571429;3840.714286;3881.428571;41.80453382;3820
TLKM.JK;03/05/19;3800;3830;3760;3820;3292.985107;101522800;70;20;3835.714286;3840.714286;3876.666667;41.57609203;3840
TLKM.JK;06/05/19;3760;3840;3720;3840;3310.22583;107167400;120;80;3832.857143;3840;3866.666667;41.91828786;3900
TLKM.JK;07/05/19;3870;3910;3840;3900;3361.947998;74814500;70;30;3834.285714;3837.857143;3856.190476;41.97504928;3900
TLKM.JK;08/05/19;3890;3920;3870;3900;3361.947998;77743400;50;10;3832.857143;3840;3853.809524;39.03600292;3800
TLKM.JK;09/05/19;3860;3900;3800;3800;3275.743896;74716500;100;-60;3838.571429;3842.857143;3851.428571;45.98136268;3790
TLKM.JK;10/05/19;3800;3840;3790;3790;3267.124023;66672500;50;-10;3840;3838.571429;3845.238095;44.34711565;3770
TLKM.JK;13/05/19;3820;3840;3760;3770;3249.883057;47605100;80;-50;3840;3839.285714;3840.47619;44.34711565;3760
TLKM.JK;14/05/19;3730;3800;3720;3760;3241.262451;77483200;80;30;3831.428571;3833.571429;3837.619048;51.77791403;3660
TLKM.JK;15/05/19;3770;3790;3660;3660;3155.058594;57596600;130;-110;3822.857143;3827.857143;3834.285714;58.51332775;3600
TLKM.JK;16/05/19;3660;3720;3530;3600;3103.33667;107366200;190;-60;3797.142857;3815.714286;3824.285714;83.80817098;3510
TLKM.JK;17/05/19;3610;3620;3500;3510;3025.753174;94437400;120;-100;3754.285714;3793.571429;3811.428571;97.9552862;3600
TLKM.JK;20/05/19;3520;3620;3480;3600;3103.33667;82354400;140;80;3698.571429;3768.571429;3794.761905;111.2697281;3600
TLKM.JK;21/05/19;3600;3630;3550;3600;3103.33667;106104000;80;0;3670;3755;3782.380952;106.4581295;3540
TLKM.JK;22/05/19;3590;3600;3540;3540;3051.614258;63687000;60;-50;3642.857143;3741.428571;3773.809524;94.28932172;3660
TLKM.JK;23/05/19;3540;3690;3540;3660;3155.058594;113281100;150;120;3610;3720.714286;3759.047619;81.85352772;3750
TLKM.JK;24/05/19;3700;3780;3690;3750;3232.642334;87594500;90;50;3595.714286;3709.285714;3750.47619;55.93363414;3820
TLKM.JK;27/05/19;3760;3830;3750;3820;3292.985107;87146600;80;60;3608.571429;3702.857143;3746.666667;78.83074092;3690
TLKM.JK;28/05/19;3800;3820;3690;3690;3180.920166;322246900;130;-110;3640;3697.142857;3742.380952;111.8033989;3780
TLKM.JK;29/05/19;3750;3830;3730;3780;3258.503418;122534500;100;30;3665.714286;3682.142857;3734.285714;96.58452997;3780
TLKM.JK;30/05/19;3780;3780;3780;3780;3258.503418;0;0;0;3691.428571;3680.714286;3733.809524;100.0714031;3900
TLKM.JK;31/05/19;3780;3930;3780;3900;3361.947998;194331700;150;120;3717.142857;3680;3733.333333;95.69296138;3900
TLKM.JK;03/06/19;3900;3900;3900;3900;3361.947998;0;0;0;3768.571429;3689.285714;3736.666667;80.08923595;3900
TLKM.JK;04/06/19;3900;3900;3900;3900;3361.947998;0;0;0;3802.857143;3699.285714;3740.47619;77.18252948;3900
TLKM.JK;05/06/19;3900;3900;3900;3900;3361.947998;0;0;0;3824.285714;3716.428571;3743.333333;80.79957567;3900
TLKM.JK;06/06/19;3900;3900;3900;3900;3361.947998;0;0;0;3835.714286;3737.857143;3743.333333;85.60707581;3900
TLKM.JK;07/06/19;3900;3900;3900;3900;3361.947998;0;0;0;3865.714286;3765.714286;3743.333333;58.55400438;4040
TLKM.JK;10/06/19;4000;4060;3970;4040;3482.633301;222522800;90;40;3882.857143;3787.142857;3748.095238;45.35573676;4020
TLKM.JK;11/06/19;4010;4060;4000;4020;3465.392578;88861700;60;10;3920;3818.571429;3760;52.91502622;3940
TLKM.JK;12/06/19;3880;3950;3840;3940;3443.20166;134724400;110;60;3937.142857;3852.857143;3771.904762;63.69570517;3990
TLKM.JK;13/06/19;3940;3990;3900;3990;3486.897217;115734700;90;50;3942.857143;3872.857143;3780.47619;61.56684327;3990
TLKM.JK;14/06/19;4020;4050;3970;3990;3486.897217;92466800;80;-30;3955.714286;3890;3796.190476;60.51367417;3900
TLKM.JK;17/06/19;3950;3970;3900;3900;3408.245361;60851700;70;-50;3968.571429;3902.142857;3814.761905;56.10364558;3980
TLKM.JK;18/06/19;3890;3990;3890;3980;3478.158203;66112800;100;90;3968.571429;3917.142857;3833.333333;56.10364558;null
TLKM.JK;19/06/19;null;null;null;null;null;null;#VALUE!;#VALUE!;3980;3931.428571;3851.428571;47.25815626;4040
TLKM.JK;20/06/19;4110;4110;4020;4040;3530.592773;57673700;90;-70;3970;3943.076923;3864;42.89522118;4040
TLKM.JK;21/06/19;4010;4040;3950;4040;3530.592773;154049700;90;30;3973.333333;3953.846154;3889;48.02776974;3980
TLKM.JK;24/06/19;4050;4050;3970;3980;3478.158203;50525100;80;-70;3990;3964.615385;3908;51.38093031;4010
TLKM.JK;25/06/19;4040;4040;4000;4010;3504.375488;42601100;40;-30;3988.333333;3970.769231;3919.5;51.54286242;3980
TLKM.JK;26/06/19;4020;4050;3980;3980;3478.158203;56092200;70;-40;3991.666667;3979.230769;3929;52.31315959;4090
TLKM.JK;27/06/19;4010;4120;4000;4090;3574.288086;94221200;120;80;4005;3985.384615;3943.5;29.49576241;4140
TLKM.JK;28/06/19;4100;4200;4090;4140;3617.983643;130153100;110;40;4023.333333;4000;3959;42.26897996;4220
TLKM.JK;01/07/19;4200;4240;4170;4220;3687.89624;79382300;70;20;4040;4007.692308;3977;58.59465277;4250
TLKM.JK;02/07/19;4240;4250;4180;4250;3714.11377;87999800;70;10;4065.714286;4023.076923;3993;89.78811036;4240
TLKM.JK;03/07/19;4160;4240;4160;4240;3705.374512;63296200;80;80;4095.714286;4046.923077;4010.5;112.0799035;4250
TLKM.JK;04/07/19;4190;4260;4190;4250;3714.11377;38459300;70;60;4132.857143;4066.153846;4027.5;110.4104895;4280
TLKM.JK;05/07/19;4260;4280;4240;4280;3740.330811;50332800;40;20;4167.142857;4086.153846;4045;102.9100393;4270
TLKM.JK;08/07/19;4230;4290;4210;4270;3731.591797;57903400;80;40;4210;4115.384615;4064;68.7992248;4350
TLKM.JK;09/07/19;4300;4370;4270;4350;3801.504395;124822400;100;50;4235.714286;4137.692308;4082.5;46.49628761;4290
TLKM.JK;10/07/19;4310;4320;4260;4290;3749.070068;62529900;60;-20;4265.714286;4152.857143;4098;41.97504928;4270
TLKM.JK;11/07/19;4250;4280;4240;4270;3731.591797;25645900;40;20;4275.714286;4170.714286;4111.5;37.35288604;4180
TLKM.JK;12/07/19;4240;4250;4170;4180;3652.939941;57088600;80;-60;4278.571429;4187.142857;4128;35.79039509;4280
TLKM.JK;15/07/19;4250;4290;4230;4280;3740.330811;66960500;60;30;4270;4201.428571;4137.5;50.66228051;4240
TLKM.JK;16/07/19;4240;4280;4210;4240;3705.374512;45461500;70;0;4274.285714;4220.714286;4152;49.95235826;4230
TLKM.JK;17/07/19;4250;4260;4220;4230;3696.635498;32069800;40;-20;4268.571429;4239.285714;4169;51.45501965;4240
TLKM.JK;18/07/19;4220;4250;4210;4240;3705.374512;45408100;40;20;4262.857143;4249.285714;4181.5;53.45224838;4270
TLKM.JK;19/07/19;4260;4280;4250;4270;3731.591797;60692800;30;10;4247.142857;4256.428571;4184.285714;37.28908943;4260
TLKM.JK;22/07/19;4250;4270;4230;4260;3722.852783;37513700;40;10;4244.285714;4260;4195.238095;34.08672413;4250
TLKM.JK;23/07/19;4260;4270;4200;4250;3714.11377;62628100;70;-10;4242.857143;4260.714286;4205.714286;33.02235895;4190
TLKM.JK;24/07/19;4230;4240;4160;4190;3661.679199;73904300;80;-40;4252.857143;4261.428571;4218.571429;17.99470822;4210
TLKM.JK;25/07/19;4160;4240;4160;4210;3679.157227;49276300;80;50;4240;4257.142857;4227.142857;25.81988897;4160
TLKM.JK;26/07/19;4160;4210;4110;4160;3635.46167;70952400;100;0;4235.714286;4252.142857;4238.095238;28.19996623;4200
TLKM.JK;29/07/19;4150;4240;4140;4200;3670.418213;54336900;100;50;4225.714286;4244.285714;4241.428571;40.35556255;4270
TLKM.JK;30/07/19;4280;4300;4260;4270;3731.591797;88417200;40;-10;4220;4233.571429;4244.285714;40.82482905;4300
TLKM.JK;31/07/19;4240;4300;4210;4300;3757.809326;175741000;90;60;4220;4232.142857;4246.666667;40.82482905;4280
TLKM.JK;01/08/19;4300;4300;4260;4280;3740.330811;94856600;40;-20;4225.714286;4234.285714;4249.047619;49.28053803;4280
TLKM.JK;02/08/19;4280;4300;4250;4280;3740.330811;82253800;50;0;4230;4241.428571;4250.952381;52.91502622;4080
TLKM.JK;05/08/19;4200;4220;4060;4080;3565.549072;112253200;160;-120;4242.857143;4241.428571;4252.380952;52.50850271;4130
TLKM.JK;06/08/19;4060;4190;4050;4130;3609.244385;108890100;140;70;4224.285714;4230;4242.857143;81.21107126;4210
TLKM.JK;07/08/19;4230;4270;4170;4210;3679.157227;104785500;100;-20;4220;4222.857143;4236.190476;85.82928793;4260
TLKM.JK;08/08/19;4270;4290;4240;4260;3722.852783;95204000;50;-10;4221.428571;4220.714286;4229.52381;85.52359741;4260
TLKM.JK;09/08/19;4300;4300;4240;4260;3722.852783;89600500;60;-40;4220;4220;4228.095238;84.65616733;4260
TLKM.JK;12/08/19;4300;4320;4230;4260;3722.852783;41817800;90;-40;4214.285714;4220;4227.619048;79.55231881;4250
TLKM.JK;13/08/19;4290;4290;4230;4250;3714.11377;98757900;60;-40;4211.428571;4220.714286;4231.428571;77.12080814;4290
TLKM.JK;14/08/19;4300;4300;4270;4290;3749.070068;84928200;30;-10;4207.142857;4225;4230;73.41986237;4290
TLKM.JK;15/08/19;4200;4290;4200;4290;3749.070068;97255500;90;90;4237.142857;4230.714286;4232.380952;52.82495803;4280
TLKM.JK;16/08/19;4300;4310;4220;4280;3740.330811;51853900;90;-20;4260;4240;4235.238095;27.08012802;4340
TLKM.JK;19/08/19;4340;4340;4290;4340;3792.765381;86011300;50;0;4270;4245.714286;4237.142857;16.32993162;4470
TLKM.JK;20/08/19;4350;4470;4340;4470;3906.373535;143171600;130;120;4281.428571;4250.714286;4240.47619;30.23715784;4410
TLKM.JK;21/08/19;4460;4500;4390;4410;3853.939209;99649300;110;-50;4311.428571;4262.857143;4250.47619;75.5928946;4450
TLKM.JK;22/08/19;4380;4450;4320;4450;3888.895508;110968600;130;70;4332.857143;4272.142857;4258.095238;79.73169293;4380
TLKM.JK;23/08/19;4390;4450;4340;4380;3827.72168;83823900;110;-10;4361.428571;4284.285714;4270.47619;80.91735937;4330
TLKM.JK;26/08/19;4280;4360;4280;4330;3784.026611;77603200;80;50;4374.285714;4305.714286;4278.571429;74.57817886;4380
TLKM.JK;27/08/19;4390;4410;4320;4380;3827.72168;168209400;90;-10;4380;4320;4286.666667;68.31300511;4370
TLKM.JK;28/08/19;4430;4430;4350;4370;3818.982666;68091100;80;-60;4394.285714;4332.142857;4295.238095;52.55382728;4380
TLKM.JK;29/08/19;4370;4440;4370;4380;3827.72168;65718900;70;10;4398.571429;4340;4300;48.4522347;4450
TLKM.JK;30/08/19;4430;4450;4420;4450;3888.895508;95138200;30;20;4385.714286;4348.571429;4303.809524;36.90399385;4410
TLKM.JK;02/09/19;4440;4450;4400;4410;3853.939209;27531000;50;-30;4391.428571;4362.142857;4311.904762;43.75255095;4350
TLKM.JK;03/09/19;4440;4440;4330;4350;3801.504395;66884700;110;-90;4385.714286;4373.571429;4318.095238;36.90399385;4290
TLKM.JK;04/09/19;4310;4350;4280;4290;3749.070068;78905600;70;-20;4381.428571;4377.857143;4330.952381;39.33978962;4320
TLKM.JK;05/09/19;4290;4360;4290;4320;3775.287354;97098300;70;30;4375.714286;4377.857143;4338.571429;49.61758521;4210
TLKM.JK;06/09/19;4360;4360;4210;4210;3679.157227;117223300;150;-150;4367.142857;4380.714286;4343.809524;53.763149;4270
TLKM.JK;09/09/19;4280;4300;4240;4270;3731.591797;47057300;60;-10;4344.285714;4371.428571;4341.428571;79.97023256;4270
TLKM.JK;10/09/19;4300;4300;4250;4270;3731.591797;80403000;50;-30;4328.571429;4357.142857;4341.904762;82.54868693;4250
TLKM.JK;11/09/19;4300;4300;4210;4250;3714.11377;90211600;90;-50;4302.857143;4347.142857;4342.380952;64.47590912;4170
TLKM.JK;12/09/19;4220;4230;4160;4170;3644.200684;70382200;70;-50;4280;4332.857143;4342.380952;45.82575695;4160
TLKM.JK;13/09/19;4230;4230;4160;4160;3635.46167;64074800;70;-70;4254.285714;4317.857143;4336.666667;50.28490259;4220
TLKM.JK;16/09/19;4160;4260;4160;4220;3687.89624;85284700;100;60;4235.714286;4305.714286;4330.47619;58.26867164;4270
TLKM.JK;17/09/19;4240;4280;4220;4270;3731.591797;86432000;60;30;4221.428571;4294.285714;4327.619048;44.88079449;4250
TLKM.JK;18/09/19;4250;4280;4230;4250;3714.11377;72359600;50;0;4230;4287.142857;4324.285714;47.95831523;4210
TLKM.JK;19/09/19;4260;4260;4190;4210;3679.157227;58720600;70;-50;4227.142857;4277.857143;4313.809524;45.72172559;4290
TLKM.JK;20/09/19;4250;4300;4230;4290;3749.070068;132359100;70;40;4218.571429;4260.714286;4304.285714;41.80453382;4250
TLKM.JK;23/09/19;4290;4300;4230;4250;3714.11377;70483600;70;-40;4224.285714;4252.142857;4296.666667;48.94116974;4210
TLKM.JK;24/09/19;4210;4240;4150;4210;3679.157227;88979100;90;0;4235.714286;4245;4290.47619;43.14979446;4220
TLKM.JK;25/09/19;4220;4250;4180;4220;3687.89624;84582300;70;0;4242.857143;4239.285714;4284.761905;30.93772547;4360
TLKM.JK;26/09/19;4220;4370;4200;4360;3810.243408;79324000;170;140;4242.857143;4232.142857;4277.142857;30.93772547;4310
TLKM.JK;27/09/19;4310;4350;4300;4310;3766.548096;52305800;50;0;4255.714286;4242.857143;4276.666667;54.11627693;4310
TLKM.JK;30/09/19;4270;4330;4270;4310;3766.548096;111879100;60;40;4264.285714;4245.714286;4273.333333;57.69377288;4250
TLKM.JK;01/10/19;4400;4400;4220;4250;3714.11377;60332400;180;-150;4278.571429;4248.571429;4266.666667;54.29197959;4200
TLKM.JK;02/10/19;4260;4300;4190;4200;3670.418213;51606300;110;-60;4272.857143;4248.571429;4259.047619;54.98917642;4200
TLKM.JK;03/10/19;4190;4250;4160;4200;3670.418213;56433000;90;10;4265.714286;4250.714286;4251.904762;61.33436852;4190
TLKM.JK;04/10/19;4250;4250;4180;4190;3661.679199;34082000;70;-60;4264.285714;4253.571429;4247.619048;62.9436634;4110
TLKM.JK;07/10/19;4240;4240;4090;4110;3591.766357;42996900;150;-130;4260;4251.428571;4241.428571;67.33003292;4090
TLKM.JK;08/10/19;4170;4170;4060;4090;3574.288086;74448900;110;-80;4224.285714;4240;4236.666667;71.61404491;4120
TLKM.JK;09/10/19;4090;4170;4080;4120;3600.505615;59314500;90;30;4192.857143;4228.571429;4228.095238;75.87583843;4110
TLKM.JK;10/10/19;4060;4120;4060;4110;3591.766357;34345600;60;50;4165.714286;4222.142857;4220.952381;59.12053869;4170
TLKM.JK;11/10/19;4100;4170;4100;4170;3644.200684;42198800;70;70;4145.714286;4209.285714;4214.285714;48.5994317;4190
TLKM.JK;14/10/19;4200;4210;4150;4190;3661.679199;52681800;60;-10;4141.428571;4203.571429;4214.285714;44.13183712;4170
TLKM.JK;15/10/19;4190;4190;4150;4170;3644.200684;64670200;40;-20;4140;4202.142857;4215.714286;42.03173404;4170
TLKM.JK;16/10/19;4170;4190;4140;4170;3644.200684;70555700;50;0;4137.142857;4198.571429;4213.333333;38.60668583;4170
TLKM.JK;17/10/19;4160;4180;4140;4170;3644.200684;50695300;40;10;4145.714286;4185;4208.571429;38.23486317;4190
TLKM.JK;18/10/19;4170;4190;4160;4190;3661.679199;169540200;30;20;4157.142857;4175;4204.761905;29.84084768;4200
TLKM.JK;21/10/19;4200;4250;4190;4200;3670.418213;63797000;60;0;4167.142857;4166.428571;4203.809524;26.90370837;4230
TLKM.JK;22/10/19;4200;4250;4200;4230;3696.635498;56711100;50;30;4180;4162.857143;4199.52381;12.90994449;4260
TLKM.JK;23/10/19;4210;4270;4210;4260;3722.852783;97971900;60;50;4188.571429;4165;4198.571429;21.93062655;4350
TLKM.JK;24/10/19;4300;4350;4250;4350;3801.504395;99213400;100;50;4198.571429;4169.285714;4200.952381;34.84660262;4280
TLKM.JK;25/10/19;4320;4360;4270;4280;3740.330811;67661500;90;-40;4224.285714;4180.714286;4207.142857;64.25396041;4260
TLKM.JK;28/10/19;4280;4280;4220;4260;3722.852783;30710600;60;-20;4240;4192.857143;4203.333333;62.18252702;4330
TLKM.JK;29/10/19;4230;4330;4220;4330;3784.026611;68715000;110;100;4252.857143;4205;4200.952381;54.07226206;4270
TLKM.JK;30/10/19;4290;4350;4210;4270;3731.591797;89575600;140;-20;4272.857143;4220;4201.904762;52.82495803;4110
TLKM.JK;31/10/19;4220;4240;4080;4110;3591.766357;185713300;160;-110;4282.857143;4231.428571;4202.857143;42.31401884;4080
TLKM.JK;01/11/19;4090;4150;4060;4080;3565.549072;107208500;90;-10;4265.714286;4227.142857;4198.571429;77.21337165;4150
TLKM.JK;04/11/19;4080;4160;4080;4150;3626.7229;65897700;80;70;4240;4219.285714;4192.857143;104.5625809;4200
TLKM.JK;05/11/19;4170;4200;4130;4200;3670.418213;109276000;70;30;4211.428571;4217.857143;4190.952381;96.51054717;4120
TLKM.JK;06/11/19;4180;4190;4110;4120;3600.505615;134618700;80;-60;4200;4220;4195.238095;91.6515139;4070
TLKM.JK;07/11/19;4150;4150;3990;4070;3556.810059;125291200;160;-80;4180;4216.428571;4196.666667;91.6515139;4110
TLKM.JK;08/11/19;4010;4120;3990;4110;3591.766357;70404800;130;100;4142.857143;4207.857143;4194.285714;71.11359123;4100
TLKM.JK;11/11/19;4040;4120;4040;4100;3583.027344;57079800;80;60;4120;4201.428571;4194.285714;43.96968653;4180
TLKM.JK;12/11/19;4050;4190;4050;4180;3652.939941;88251100;140;130;4118.571429;4192.142857;4190.952381;44.50789122;4150
TLKM.JK;13/11/19;4130;4170;4100;4150;3626.7229;91925700;70;20;4132.857143;4186.428571;4190.47619;46.08480795;4050
TLKM.JK;14/11/19;4110;4130;4010;4050;3539.331787;123468500;120;-60;4132.857143;4172.142857;4189.52381;46.08480795;4080
TLKM.JK;15/11/19;4080;4090;4030;4080;3565.549072;50780500;60;0;4111.428571;4155.714286;4183.809524;44.50789122;4000
TLKM.JK;18/11/19;4040;4060;3990;4000;3495.63623;104978700;70;-40;4105.714286;4142.857143;4179.52381;45.77377082;4020
TLKM.JK;19/11/19;4000;4020;3970;4020;3513.114502;113996600;50;20;4095.714286;4119.285714;4170.47619;60.23762469;4090
TLKM.JK;20/11/19;4000;4090;4000;4090;3574.288086;149185500;90;90;4082.857143;4101.428571;4161.904762;66.00865744;4020
TLKM.JK;21/11/19;4050;4090;4020;4020;3513.114502;64005900;70;-30;4081.428571;4100;4155.238095;65.68322247;4050
TLKM.JK;22/11/19;4030;4050;4000;4050;3539.331787;76569400;50;20;4058.571429;4095.714286;4143.809524;52.09880723;3950
TLKM.JK;25/11/19;4070;4070;3940;3950;3451.940674;107581200;130;-120;4044.285714;4088.571429;4129.52381;33.09438163;3860
TLKM.JK;26/11/19;3950;3960;3860;3860;3373.289063;281002600;100;-90;4030;4070.714286;4113.809524;48.30458915;3880
TLKM.JK;27/11/19;3870;3930;3800;3880;3390.767334;97511300;130;10;3998.571429;4052.142857;4094.761905;74.70577207;3820
TLKM.JK;28/11/19;3830;3900;3800;3820;3338.332764;70635000;100;-10;3981.428571;4038.571429;4073.333333;87.06866475;3930
TLKM.JK;29/11/19;3860;3950;3840;3930;3434.462891;72146900;110;70;3952.857143;4017.857143;4051.904762;103.5558281;3950
TLKM.JK;02/12/19;3960;3960;3930;3950;3451.940674;74263500;30;-10;3930;4005.714286;4043.333333;84.06346809;3920
TLKM.JK;03/12/19;3920;3940;3910;3920;3425.723633;74494000;30;0;3920;3989.285714;4037.142857;75.27726527;3990
TLKM.JK;04/12/19;3920;3990;3900;3990;3486.897217;64948300;90;70;3901.428571;3972.857143;4026.190476;49.47341759;4060
TLKM.JK;05/12/19;3990;4080;3990;4060;3548.070801;118494800;90;70;3907.142857;3968.571429;4016.190476;57.65248931;4100
TLKM.JK;06/12/19;4040;4100;4020;4100;3583.027344;50682100;80;60;3935.714286;3967.142857;4013.333333;76.78045386;4070
TLKM.JK;09/12/19;4080;4110;4050;4070;3556.810059;80864200;60;-10;3967.142857;3974.285714;4014.761905;93.40133577;4040
TLKM.JK;10/12/19;4050;4070;4010;4040;3530.592773;54824900;60;-10;4002.857143;3977.857143;4012.857143;73.41986237;4050
TLKM.JK;11/12/19;4010;4050;4000;4050;3539.331787;79749500;50;40;4018.571429;3974.285714;4010;66.69047194;3950
TLKM.JK;12/12/19;4040;4050;3950;3950;3451.940674;147627000;100;-90;4032.857143;3976.428571;4003.809524;59.92058236;3990
TLKM.JK;13/12/19;4000;4020;3960;3990;3486.897217;81937300;60;-10;4037.142857;3969.285714;3994.285714;50.89672082;3970
TLKM.JK;16/12/19;3970;4020;3960;3970;3469.419189;86479200;60;0;4037.142857;3972.142857;3991.428571;50.89672082;3980
TLKM.JK;17/12/19;3970;3990;3950;3980;3478.158203;91747200;40;10;4024.285714;3980;3986.190476;55.33448077;3990
TLKM.JK;18/12/19;3960;4000;3950;3990;3486.897217;101569300;50;30;4007.142857;3987.142857;3985.238095;45.72172559;3900
TLKM.JK;19/12/19;3970;3980;3900;3900;3408.245361;127316000;80;-70;3995.714286;3999.285714;3983.809524;36.44957378;4020
TLKM.JK;20/12/19;3900;4020;3900;4020;3513.114502;152132200;120;120;3975.714286;3997.142857;3974.761905;45.40820148;4020
TLKM.JK;23/12/19;4020;4030;3980;4020;3513.114502;58715700;50;0;3971.428571;4002.142857;3974.761905;38.04758925;4000
TLKM.JK;26/12/19;4020;4020;3980;4000;3495.63623;36935300;40;-20;3981.428571;4009.285714;3973.333333;40.59087395;3990
TLKM.JK;27/12/19;3990;4010;3980;3990;3486.897217;52812000;30;0;3982.857143;4010;3975.714286;41.11540089;3970
TLKM.JK;30/12/19;3980;4030;3970;3970;3469.419189;67738300;60;-10;3985.714286;4005;3981.904762;40.76646614;3910
TLKM.JK;02/01/20;3970;4000;3900;3910;3416.984375;52094000;100;-60;3984.285714;3995.714286;3986.190476;41.17326918;3980
TLKM.JK;03/01/20;3960;3980;3930;3980;3478.158203;70032900;50;20;3972.857143;3984.285714;3990.47619;49.56957592;3960
TLKM.JK;06/01/20;3930;3970;3930;3960;3460.679932;42908900;40;30;3984.285714;3980;3992.857143;37.7964473;3940
TLKM.JK;07/01/20;3930;3970;3920;3940;3443.20166;51837600;50;10;3975.714286;3973.571429;3993.333333;35.05098328;3900
TLKM.JK;08/01/20;3920;3950;3900;3900;3408.245361;52402600;50;-20;3964.285714;3972.857143;3994.285714;31.0145895;3960
TLKM.JK;09/01/20;3920;3970;3920;3960;3460.679932;37580300;50;40;3950;3966.428571;3990;34.64101615;3980
TLKM.JK;10/01/20;3980;3990;3950;3980;3478.158203;48099000;40;0;3945.714286;3965.714286;3985.238095;30.47247001;4030
TLKM.JK;13/01/20;4000;4030;3990;4030;3521.853516;61913800;40;30;3947.142857;3965.714286;3979.52381;31.99702367;3950
TLKM.JK;14/01/20;3980;4000;3940;3950;3451.940674;95058600;60;-30;3964.285714;3968.571429;3977.619048;39.94043184;3880
TLKM.JK;15/01/20;3960;3960;3870;3880;3390.767334;147583300;90;-80;3960;3972.142857;3973.333333;39.58114029;3850
TLKM.JK;16/01/20;3890;3890;3830;3850;3364.549805;118903100;60;-40;3948.571429;3962.142857;3965.238095;49.80915961;3810
TLKM.JK;17/01/20;3860;3870;3800;3810;3329.593506;119904100;70;-50;3935.714286;3950;3960.47619;62.41184259;3810
TLKM.JK;20/01/20;3820;3840;3800;3810;3329.593506;73599200;40;-10;3922.857143;3936.428571;3951.904762;78.25477317;3890
TLKM.JK;21/01/20;3810;3900;3810;3890;3399.506348;78014400;90;80;3901.428571;3923.571429;3944.285714;86.49249899;3860
TLKM.JK;22/01/20;3890;3890;3850;3860;3373.289063;45839800;40;-30;3888.571429;3917.857143;3940;79.25245978;3880
TLKM.JK;23/01/20;3860;3880;3830;3880;3390.767334;41077400;50;20;3864.285714;3914.285714;3933.809524;48.94116974;3920
TLKM.JK;24/01/20;3880;3930;3860;3920;3425.723633;58524000;70;40;3854.285714;3907.142857;3932.857143;33.09438163;3840
TLKM.JK;27/01/20;3920;3920;3830;3840;3355.811035;33081800;90;-80;3860;3904.285714;3928.095238;40.82482905;3830
TLKM.JK;28/01/20;3810;3840;3800;3830;3347.071777;56210000;40;20;3858.571429;3897.142857;3919.52381;41.40393356;3900
TLKM.JK;29/01/20;3840;3900;3840;3900;3408.245361;51929800;60;60;3861.428571;3892.142857;3911.428571;38.04758925;3860
TLKM.JK;30/01/20;3910;3910;3850;3860;3373.289063;60391600;60;-50;3874.285714;3887.857143;3907.142857;32.58688021;3800
TLKM.JK;31/01/20;3890;3890;3780;3800;3320.854248;120447900;110;-90;3870;3879.285714;3901.904762;32.14550254;3740
TLKM.JK;03/02/20;3800;3820;3730;3740;3268.420166;68360600;90;-60;3861.428571;3862.857143;3896.666667;41.80453382;3760
TLKM.JK;04/02/20;3810;3810;3730;3760;3285.897949;77259600;80;-50;3841.428571;3847.857143;3885.238095;60.67085281;3770
TLKM.JK;05/02/20;3760;3780;3720;3770;3294.637207;68150800;60;10;3818.571429;3839.285714;3875.714286;56.10364558;3760
TLKM.JK;06/02/20;3800;3800;3750;3760;3285.897949;56261500;50;-40;3808.571429;3833.571429;3867.619048;57.85861256;3790
TLKM.JK;07/02/20;3780;3820;3760;3790;3312.115723;53578900;60;10;3798.571429;3830;3860.952381;59.56189258;3810
TLKM.JK;10/02/20;3800;3850;3780;3810;3329.593506;86588500;70;10;3782.857143;3828.571429;3852.857143;39.46064948;3790
TLKM.JK;11/02/20;3810;3830;3780;3790;3312.115723;50248200;50;-20;3775.714286;3822.857143;3844.761905;25.07132682;3820
TLKM.JK;12/02/20;3800;3850;3780;3820;3338.332764;73840300;70;20;3774.285714;3817.857143;3833.333333;23.70453041;3730
TLKM.JK;13/02/20;3820;3830;3710;3730;3259.680908;66699800;120;-90;3785.714286;3813.571429;3827.142857;23.70453041;3640
TLKM.JK;14/02/20;3680;3730;3640;3640;3181.029297;108793300;90;-40;3781.428571;3800;3820;30.78342164;3610
TLKM.JK;17/02/20;3630;3660;3590;3610;3154.811768;94887800;70;-20;3762.857143;3785.714286;3810;62.10590034;3620
TLKM.JK;18/02/20;3590;3660;3590;3620;3163.550781;94382900;70;30;3741.428571;3770;3800.47619;84.93695141;3620
TLKM.JK;19/02/20;3620;3640;3590;3620;3163.550781;63717800;50;0;3717.142857;3750;3791.428571;92.68482179;3630
TLKM.JK;20/02/20;3620;3650;3600;3630;3172.290039;53035400;50;10;3690;3732.857143;3778.571429;88.6942313;3690
TLKM.JK;21/02/20;3650;3710;3640;3690;3224.724609;86862600;70;40;3667.142857;3720.714286;3767.619048;78.67957925;3640
TLKM.JK;24/02/20;3670;3720;3630;3640;3181.029297;72610600;90;-30;3648.571429;3717.142857;3758.571429;44.50789122;3590
TLKM.JK;25/02/20;3600;3670;3590;3590;3137.33374;73990700;80;-10;3635.714286;3708.571429;3745.238095;26.367368;3510
TLKM.JK;26/02/20;3530;3550;3450;3510;3067.420898;133449900;100;-20;3628.571429;3695.714286;3733.333333;31.32015934;3470
TLKM.JK;27/02/20;3510;3550;3420;3470;3032.4646;88389400;130;-40;3614.285714;3677.857143;3718.095238;55.03245796;3490
TLKM.JK;28/02/20;3390;3490;3340;3490;3049.942627;151751800;150;100;3592.857143;3655;3697.619048;77.18252948;3440
TLKM.JK;02/03/20;3470;3550;3440;3440;3006.24707;96802900;110;-30;3574.285714;3632.142857;3680;84.82474931;3620
TLKM.JK;03/03/20;3510;3660;3470;3620;3163.550781;114698200;190;110;3547.142857;3607.142857;3662.857143;93.93513466;3830
TLKM.JK;04/03/20;3640;3840;3630;3830;3347.071777;136081000;210;190;3537.142857;3592.857143;3657.142857;78.67957925;3830
TLKM.JK;05/03/20;3820;3880;3760;3830;3347.071777;101235000;120;10;3564.285714;3600;3660.47619;133.6484372;3750
TLKM.JK;06/03/20;3730;3790;3710;3750;3277.15918;86476000;80;20;3598.571429;3613.571429;3663.333333;167.7725217;3500
TLKM.JK;09/03/20;3560;3620;3500;3500;3058.681641;109347300;120;-60;3632.857143;3623.571429;3662.857143;171.1446061;3490
TLKM.JK;10/03/20;3480;3620;3480;3490;3049.942627;119718000;140;10;3637.142857;3615;3649.047619;166.7047576;3400
TLKM.JK;11/03/20;3470;3480;3370;3400;2971.290771;115486900;110;-70;3637.142857;3605.714286;3633.809524;166.7047576;3310
TLKM.JK;12/03/20;3300;3440;3270;3310;2892.63916;84363800;170;10;3631.428571;3589.285714;3615.238095;175.0646139;3310
TLKM.JK;13/03/20;3310;3310;3310;3310;2892.63916;0;0;0;3587.142857;3562.142857;3590.952381;213.441193;3160
TLKM.JK;16/03/20;3300;3300;3160;3160;2761.552734;115972300;140;-140;3512.857143;3538.571429;3570.952381;205.1596359;2940
TLKM.JK;17/03/20;3160;3160;2940;2940;2569.292725;150122700;220;-220;3417.142857;3507.857143;3548.095238;188.1235663;2810
TLKM.JK;18/03/20;3010;3080;2740;2810;2455.68457;150147300;340;-200;3301.428571;3467.142857;3516.190476;198.1101185;2620
TLKM.JK;19/03/20;2810;2810;2620;2620;2289.641846;138987300;190;-190;3202.857143;3420;3477.619048;248.1742859;2880
TLKM.JK;20/03/20;2660;2990;2450;2880;2516.85791;267694700;540;220;3078.571429;3357.857143;3430;294.0197596;2680
TLKM.JK;23/03/20;2880;2880;2680;2680;2342.076172;86157200;200;-200;3004.285714;3317.857143;3394.285714;263.3664837;2620
TLKM.JK;24/03/20;2700;2880;2570;2620;2289.641846;243778900;310;-80;2914.285714;3250.714286;3346.190476;248.7205355;2980
TLKM.JK;26/03/20;2550;3080;2550;2980;2604.249268;267369500;530;430;2815.714286;3164.285714;3297.619048;197.1342303;3090
TLKM.JK;27/03/20;3050;3270;3050;3090;2700.37915;200952500;220;40;2790;3103.571429;3268.571429;151.1070261;3140
TLKM.JK;30/03/20;3060;3180;2880;3140;2744.074463;134474300;300;80;2811.428571;3056.428571;3248.571429;183.1600913;3160
TLKM.JK;31/03/20;3180;3300;3120;3160;2761.552734;151302900;180;-20;2858.571429;3030.714286;3232.857143;221.2410881;3100
TLKM.JK;01/04/20;3180;3200;3040;3100;2709.11792;104550600;160;-80;2935.714286;3007.142857;3217.142857;218.3160662;3130
TLKM.JK;02/04/20;3100;3130;3020;3130;2735.335693;92893600;110;30;2967.142857;2985.714286;3200.952381;224.7008593;3200
TLKM.JK;03/04/20;3150;3220;3120;3200;2796.509033;83469200;100;50;3031.428571;2972.857143;3177.619048;190.6505155;3330
TLKM.JK;06/04/20;3280;3330;3180;3330;2910.117432;115495000;150;50;3114.285714;2965;3147.619048;69.72736021;3220
TLKM.JK;07/04/20;3390;3500;3200;3220;2813.987305;166425600;300;-170;3164.285714;2977.142857;3123.809524;81.82443459;3110
TLKM.JK;08/04/20;3220;3220;3050;3110;2717.857178;124553900;170;-110;3182.857143;2997.142857;3098.571429;76.74943772;3120
TLKM.JK;09/04/20;3110;3180;3030;3120;2726.596436;122622400;150;10;3178.571429;3018.571429;3080;80.29706749;3180
TLKM.JK;13/04/20;3140;3230;3130;3180;2779.031006;45469500;100;40;3172.857143;3054.285714;3062.380952;83.2094317;3240
TLKM.JK;14/04/20;3200;3250;3160;3240;2831.465332;79114600;90;40;3184.285714;3075.714286;3051.904762;76.78045386;3110
TLKM.JK;15/04/20;3250;3300;3090;3110;2717.857178;69832000;210;-140;3200;3115.714286;3048.571429;75.05553499;3000
TLKM.JK;16/04/20;3110;3110;3000;3000;2621.727295;109582500;110;-110;3187.142857;3150.714286;3039.047619;82.4043457;3230
TLKM.JK;17/04/20;3050;3250;3050;3230;2822.726563;127860400;200;180;3140;3152.142857;3031.428571;81.44527815;3120
TLKM.JK;20/04/20;3270;3270;3120;3120;2726.596436;77306900;150;-150;3141.428571;3162.142857;3045.238095;83.15218406;3070
TLKM.JK;21/04/20;3120;3130;3050;3070;2682.900879;43239400;80;-50;3142.857143;3160.714286;3060;82.60635281;3160
TLKM.JK;22/04/20;3050;3270;3030;3160;2761.552734;126278300;240;110;3135.714286;3154.285714;3081.428571;86.95921321;3070
TLKM.JK;23/04/20;3200;3240;3070;3070;2682.900879;117391500;170;-130;3132.857143;3158.571429;3094.761905;85.57925872;3090
TLKM.JK;24/04/20;3100;3160;3080;3090;2700.37915;84061400;80;-10;3108.571429;3154.285714;3113.333333;73.35497516;3150
TLKM.JK;27/04/20;3120;3200;3100;3150;2752.813477;85475400;100;30;3105.714286;3146.428571;3135.714286;73.67883976;3160
TLKM.JK;28/04/20;3170;3200;3140;3160;2761.552734;80212700;60;-10;3127.142857;3133.571429;3143.809524;57.94085654;3350
TLKM.JK;29/04/20;3200;3390;3100;3350;2927.595459;154902100;290;150;3117.142857;3129.285714;3147.142857;40.70801957;3500
TLKM.JK;30/04/20;3400;3540;3350;3500;3058.681641;163170100;190;100;3150;3146.428571;3157.142857;97.12534856;3320
TLKM.JK;04/05/20;3400;3400;3260;3320;2901.378174;108988600;140;-80;3211.428571;3173.571429;3173.333333;156.1440117;3320
TLKM.JK;05/05/20;3320;3390;3320;3320;2901.378174;74036700;70;0;3234.285714;3183.571429;3183.809524;159.0447676;3240
TLKM.JK;06/05/20;3300;3340;3220;3240;2831.465332;86395000;120;-60;3270;3189.285714;3192.857143;143.2945684;3190
TLKM.JK;08/05/20;3270;3290;3150;3190;2787.77002;143584400;140;-80;3291.428571;3198.571429;3194.761905;121.4397754;3220
TLKM.JK;11/05/20;3220;3250;3210;3220;2813.987305;58473100;40;0;3297.142857;3212.142857;3188.095238;114.4136189;3150
TLKM.JK;12/05/20;3270;3270;3100;3150;2752.813477;138978700;170;-120;3305.714286;3211.428571;3188.095238;104.2204623;3160
TLKM.JK;13/05/20;3150;3170;3080;3160;2761.552734;73238700;90;10;3277.142857;3213.571429;3190;116.7210757;3070
TLKM.JK;14/05/20;3110;3140;3060;3070;2682.900879;101581300;80;-40;3228.571429;3220;3191.904762;69.8638131;3100
TLKM.JK;15/05/20;3100;3130;3020;3100;2709.11792;114753900;110;0;3192.857143;3213.571429;3186.666667;78.67957925;3220
TLKM.JK;18/05/20;3100;3220;3100;3220;2813.987305;108828800;120;120;3161.428571;3215.714286;3180;61.48944935;3270
TLKM.JK;19/05/20;3250;3330;3250;3270;2857.682861;97387100;80;20;3158.571429;3225;3185.238095;57.56983337;3180
TLKM.JK;20/05/20;3200;3260;3180;3180;2779.031006;76086600;80;-20;3170;3233.571429;3198.095238;71.18052168;3250
TLKM.JK;26/05/20;3150;3280;3130;3250;2840.204346;105792900;150;100;3164.285714;3235;3195.714286;68.03360514;3170
TLKM.JK;27/05/20;3250;3270;3150;3170;2770.291748;128693900;120;-80;3178.571429;3227.857143;3201.904762;74.70577207;3130
TLKM.JK;28/05/20;3180;3210;3130;3130;2735.335693;177385100;80;-50;3180;3204.285714;3206.666667;74.38637868;3150
TLKM.JK;29/05/20;3100;3150;3080;3150;2752.813477;276092100;70;50;3188.571429;3190.714286;3205.238095;62.029179;3250
TLKM.JK;02/06/20;3160;3270;3120;3250;2840.204346;174790600;150;90;3195.714286;3178.571429;3209.047619;52.23572943;3290
TLKM.JK;03/06/20;3280;3320;3230;3290;2875.160645;216200900;90;10;3200;3179.285714;3216.666667;55.67764363;3300
TLKM.JK;04/06/20;3320;3390;3250;3300;2883.899902;167708600;140;-20;3202.857143;3186.428571;3223.333333;60.19808572;3230
TLKM.JK;05/06/20;3360;3360;3200;3230;2822.726563;188420700;160;-130;3220;3192.142857;3230;69.04105059;3230
TLKM.JK;08/06/20;3250;3290;3220;3230;2822.726563;221641600;70;-20;3217.142857;3197.857143;3224.285714;67.99859943;3140
TLKM.JK;09/06/20;3250;3270;3140;3140;2744.074463;171214500;130;-110;3225.714286;3202.857143;3211.428571;64.77065767;3110
TLKM.JK;10/06/20;3150;3190;3100;3110;2717.857178;263483700;90;-40;3227.142857;3207.857143;3202.857143;62.37368187;3080
TLKM.JK;11/06/20;3120;3150;3060;3080;2691.640137;175767800;90;-40;3221.428571;3208.571429;3192.857143;71.74690967;3030
TLKM.JK;12/06/20;3080;3080;2970;3030;2647.94458;260087300;110;-50;3197.142857;3198.571429;3185.238095;87.50510189;3090
TLKM.JK;15/06/20;3060;3150;3030;3090;2700.37915;241625700;120;30;3160;3181.428571;3177.619048;96.26352719;3200
TLKM.JK;16/06/20;3150;3220;3130;3200;2796.509033;194424800;90;50;3130;3175;3171.428571;75.93857167;3210
TLKM.JK;17/06/20;3210;3230;3140;3210;2805.248047;177784900;90;0;3125.714286;3171.428571;3173.809524;69.96597813;3280
TLKM.JK;18/06/20;3210;3350;3180;3280;2866.421875;235586600;170;70;3122.857143;3174.285714;3176.190476;65.24678427;3280
TLKM.JK;19/06/20;3300;3340;3250;3280;2866.421875;227358800;90;-20;3142.857143;3185;3186.190476;88.64052604;3200
TLKM.JK;22/06/20;3290;3300;3180;3200;2796.509033;159776500;120;-90;3167.142857;3194.285714;3194.761905;100.6171433;3130
TLKM.JK;23/06/20;3200;3200;3120;3130;2735.335693;167271000;80;-70;3184.285714;3190.714286;3193.809524;93.24826055;3180
TLKM.JK;24/06/20;3150;3230;3140;3180;2779.031006;170895600;90;30;3198.571429;3179.285714;3187.142857;70.57586259;3160
TLKM.JK;25/06/20;3160;3220;3140;3160;2761.552734;100882600;80;0;3211.428571;3170.714286;3187.142857;53.67450401;3190
TLKM.JK;26/06/20;3190;3220;3180;3190;2787.77002;100784500;40;0;3205.714286;3165.714286;3182.857143;57.11308748;3180
TLKM.JK;29/06/20;3200;3250;3160;3180;2779.031006;156613200;90;-20;3202.857143;3162.857143;3183.809524;57.36267245;3050
TLKM.JK;30/06/20;3090;3100;3050;3050;2801.135254;258068400;50;-40;3188.571429;3165.714286;3186.190476;46.3424109;3040
TLKM.JK;01/07/20;3070;3100;3010;3040;2791.951172;148037400;90;-30;3155.714286;3161.428571;3181.428571;51.91568256;3140
TLKM.JK;02/07/20;3040;3140;3040;3140;2883.791504;178357900;100;100;3132.857143;3158.571429;3171.428571;63.17021601;3120
TLKM.JK;03/07/20;3150;3180;3110;3120;2865.423584;102033100;70;-30;3134.285714;3166.428571;3164.285714;63.20789583;3050
TLKM.JK;06/07/20;3130;3150;3040;3050;2801.135254;248572600;110;-80;3125.714286;3168.571429;3155.714286;59.96030433;3120
TLKM.JK;07/07/20;3060;3120;3050;3120;2865.423584;169104200;70;60;3110;3157.857143;3147.142857;63.77042157;3150
TLKM.JK;08/07/20;3130;3160;3110;3150;2892.975586;158166300;50;20;3100;3151.428571;3141.904762;53.85164807;3110
TLKM.JK;09/07/20;3170;3190;3110;3110;2856.239502;125940800;80;-60;3095.714286;3142.142857;3142.380952;47.20774755;3110
TLKM.JK;10/07/20;3110;3130;3100;3110;2856.239502;95422400;30;0;3104.285714;3130;3142.380952;42.76179871;3090
TLKM.JK;13/07/20;3120;3130;3080;3090;2837.871338;77733900;50;-30;3114.285714;3123.571429;3143.809524;32.07134903;3080
TLKM.JK;14/07/20;3100;3110;3070;3080;2828.6875;111442600;40;-20;3107.142857;3120.714286;3146.666667;30.93772547;3090
TLKM.JK;15/07/20;3120;3130;3080;3090;2837.871338;102304100;50;-30;3101.428571;3113.571429;3146.190476;31.84785259;3100
TLKM.JK;16/07/20;3090;3110;3080;3100;2847.05542;91951000;30;10;3107.142857;3108.571429;3140.952381;23.60387377;3060
TLKM.JK;17/07/20;3100;3110;3060;3060;2810.319336;112416300;50;-40;3104.285714;3102.142857;3135.714286;22.99068134;3060
TLKM.JK;20/07/20;3080;3080;3040;3060;2810.319336;64735500;40;-20;3091.428571;3093.571429;3125.238095;17.72810521;3060
TLKM.JK;21/07/20;3050;3110;3050;3060;2810.319336;101283800;60;10;3084.285714;3094.285714;3114.761905;19.02379462;3070
TLKM.JK;22/07/20;3070;3090;3060;3070;2819.503418;69462100;30;0;3077.142857;3095.714286;3108.095238;17.04336206;3070
TLKM.JK;23/07/20;3070;3090;3060;3070;2819.503418;70482100;30;0;3074.285714;3090.714286;3105.238095;16.18347187;3020
TLKM.JK;24/07/20;3080;3080;3020;3020;2773.583008;137265100;60;-60;3072.857143;3087.142857;3100;16.03567451;3040
TLKM.JK;27/07/20;3020;3050;3020;3040;2791.951172;58708800;30;20;3062.857143;3085;3093.333333;23.60387377;3020
TLKM.JK;28/07/20;3050;3050;3010;3020;2773.583008;102705300;40;-30;3054.285714;3079.285714;3086.190476;18.12653934;3000
TLKM.JK;29/07/20;3030;3050;3000;3000;2755.214844;114352000;50;-30;3048.571429;3070;3078.571429;21.93062655;3050
TLKM.JK;30/07/20;3040;3050;3000;3050;2801.135254;95785000;50;10;3040;3062.142857;3076.190476;27.68874621;2920
TLKM.JK;03/08/20;3060;3060;2850;2920;2681.742676;255659800;210;-140;3038.571429;3057.857143;3076.666667;26.72612419;2950
TLKM.JK;04/08/20;2970;2970;2920;2950;2709.294678;96018000;50;-20;3017.142857;3045.714286;3066.190476;48.55041562;3020
TLKM.JK;05/08/20;2960;3040;2920;3020;2773.583008;120719100;120;60;3000;3036.428571;3058.095238;47.95831523;3020
TLKM.JK;06/08/20;3050;3050;3000;3020;2773.583008;71699000;50;-30;3000;3031.428571;3056.666667;47.95831523;2980
TLKM.JK;07/08/20;3020;3030;2970;2980;2736.846924;78347200;60;-40;2997.142857;3025.714286;3051.904762;45.72172559;2970
TLKM.JK;10/08/20;3000;3020;2970;2970;2727.662842;65485400;50;-30;2991.428571;3020;3043.809524;44.88079449;2930
TLKM.JK;11/08/20;2980;3000;2930;2930;2690.926514;175693000;70;-50;2987.142857;3013.571429;3037.142857;45.35573676;2950
TLKM.JK;12/08/20;2930;2960;2920;2950;2709.294678;110934800;40;20;2970;3004.285714;3028.571429;40;3010
TLKM.JK;13/08/20;2950;3020;2950;3010;2764.398926;160906600;70;60;2974.285714;2995.714286;3021.904762;35.05098328;3030
TLKM.JK;14/08/20;3020;3040;3000;3030;2782.76709;93007500;40;10;2982.857143;2991.428571;3018.571429;35.45621042;3050
TLKM.JK;18/08/20;3030;3060;3000;3050;2801.135254;139358500;60;20;2984.285714;2992.142857;3015.714286;37.35288604;3000
TLKM.JK;19/08/20;3050;3050;3000;3000;2755.214844;103980600;50;-50;2988.571429;2992.857143;3013.333333;43.3699479;3000
TLKM.JK;24/08/20;3010;3020;2990;3000;2755.214844;76713900;30;-10;2991.428571;2991.428571;3010.47619;43.3699479;2980
TLKM.JK;25/08/20;3010;3010;2980;2980;2736.846924;100013600;30;-30;2995.714286;2991.428571;3007.619048;42.37025012;3020
TLKM.JK;26/08/20;2980;3050;2980;3020;2773.583008;122465300;70;40;3002.857143;2986.428571;3003.809524;32.51373336;2990
TLKM.JK;27/08/20;3020;3040;2970;2990;2746.030762;102787800;70;-30;3012.857143;2993.571429;3001.428571;22.88688541;2960
TLKM.JK;28/08/20;2990;2990;2940;2960;2718.47876;160569500;50;-30;3010;2996.428571;2997.619048;24.49489743;2860
TLKM.JK;31/08/20;2960;2980;2860;2860;2626.638184;204261100;120;-100;3000;2992.142857;2994.761905;28.86751346;2900
TLKM.JK;01/09/20;2900;2910;2860;2900;2663.374512;90565400;50;0;2972.857143;2980.714286;2986.190476;53.13952883;2950
TLKM.JK;02/09/20;2900;2970;2900;2950;2709.294678;107589800;70;50;2958.571429;2975;2980.47619;57.85861256;2900
TLKM.JK;03/09/20;2950;2960;2880;2900;2663.374512;123106100;80;-50;2951.428571;2973.571429;2978.095238;54.902511;2860
TLKM.JK;04/09/20;2850;2890;2840;2860;2626.638184;143569100;50;10;2940;2971.428571;2970.952381;56.27314339;2900
TLKM.JK;07/09/20;2870;2910;2870;2900;2663.374512;62206600;40;30;2917.142857;2965;2968.095238;50.56820006;2860
TLKM.JK;08/09/20;2890;2900;2860;2860;2626.638184;80068200;40;-30;2904.285714;2957.142857;2965.714286;39.0969491;2800
TLKM.JK;09/09/20;2850;2860;2800;2800;2571.533936;108397400;60;-50;2890;2945;2958.095238;33.1662479;2700
TLKM.JK;10/09/20;2800;2800;2620;2700;2479.693359;287496300;180;-100;2881.428571;2927.142857;2947.619048;47.05619741;2810
TLKM.JK;11/09/20;2670;2840;2650;2810;2580.718018;197756800;190;140;2852.857143;2905.714286;2934.285714;81.7953311;2890
TLKM.JK;14/09/20;2830;2890;2820;2890;2654.19043;127562700;70;60;2832.857143;2892.142857;2926.666667;70.40698017;2830
TLKM.JK;15/09/20;2890;2900;2810;2830;2599.085938;106215900;90;-60;2831.428571;2885.714286;2924.761905;68.90296835;2790
TLKM.JK;16/09/20;2810;2830;2770;2790;2562.349854;68113400;60;-20;2827.142857;2872.142857;2919.047619;67.753053;2820
TLKM.JK;17/09/20;2810;2850;2780;2820;2589.9021;97257400;70;10;2811.428571;2857.857143;2908.571429;60.39552175;2890
TLKM.JK;18/09/20;2850;2890;2840;2890;2654.19043;162116700;50;40;2805.714286;2847.857143;2898.571429;56.82051943;2810
TLKM.JK;21/09/20;2890;2910;2800;2810;2580.718018;100305100;110;-80;2818.571429;2850;2890.952381;64.9175301;2780
TLKM.JK;22/09/20;2790;2810;2750;2780;2553.165771;75891600;60;-10;2834.285714;2843.571429;2881.904762;39.94043184;2800
TLKM.JK;23/09/20;2770;2810;2740;2800;2571.533936;85953300;70;30;2830;2831.428571;2871.428571;44.34711565;2730
TLKM.JK;24/09/20;2750;2760;2710;2730;2507.245605;74516800;50;-20;2817.142857;2824.285714;2862.857143;36.38419332;2690
TLKM.JK;25/09/20;2720;2740;2670;2690;2470.509277;180968900;70;-30;2802.857143;2815;2849.047619;48.20590756;2660
TLKM.JK;28/09/20;2710;2730;2660;2660;2442.957275;89256700;70;-50;2788.571429;2800;2834.761905;64.66028442;2630
TLKM.JK;29/09/20;2690;2690;2630;2630;2415.405029;155853900;60;-60;2765.714286;2785.714286;2820.47619;78.497801;2560
TLKM.JK;30/09/20;2630;2650;2540;2560;2351.116699;235611600;110;-70;2728.571429;2773.571429;2809.52381;71.04659772;2750
TLKM.JK;01/10/20;2600;2760;2600;2750;2525.61377;225006000;160;150;2692.857143;2763.571429;2793.333333;84.79667559;2680
TLKM.JK;02/10/20;2750;2750;2650;2680;2461.325195;140161900;100;-70;2688.571429;2759.285714;2783.809524;80.29706749;2650
TLKM.JK;05/10/20;2690;2710;2640;2650;2433.773193;124720200;70;-40;2671.428571;2744.285714;2773.333333;63.62090103;2650
TLKM.JK;06/10/20;2680;2700;2620;2650;2433.773193;148977400;80;-30;2660;2731.428571;2763.333333;58.30951895;2660
TLKM.JK;07/10/20;2650;2670;2620;2660;2442.957275;110186000;50;10;2654.285714;2721.428571;2751.428571;56.82051943;2700
TLKM.JK;08/10/20;2670;2720;2650;2700;2479.693359;154587800;70;30;2654.285714;2710;2741.904762;56.82051943;2730
TLKM.JK;09/10/20;2710;2750;2700;2730;2507.245605;109122300;50;20;2664.285714;2696.428571;2737.142857;57.98193479;2730
TLKM.JK;12/10/20;2750;2760;2710;2730;2507.245605;77479100;50;-20;2688.571429;2690.714286;2738.571429;39.7611919;2730
TLKM.JK;13/10/20;2730;2740;2680;2730;2507.245605;97205500;60;0;2685.714286;2687.142857;2734.761905;35.05098328;2810
TLKM.JK;14/10/20;2730;2830;2710;2810;2580.718018;183236500;120;80;2692.857143;2682.142857;2727.142857;38.60668583;2780
TLKM.JK;15/10/20;2800;2850;2760;2780;2553.165771;138462900;90;-20;2715.714286;2687.857143;2726.190476;53.49677338;2750
TLKM.JK;16/10/20;2780;2780;2720;2750;2525.61377;135175000;60;-30;2734.285714;2694.285714;2725.714286;49.28053803;2710
TLKM.JK;19/10/20;2800;2810;2710;2710;2488.877441;187840500;100;-90;2747.142857;2700.714286;2722.380952;36.83941988;2670
TLKM.JK;20/10/20;2710;2740;2670;2670;2452.141357;168211100;70;-40;2748.571429;2706.428571;2713.809524;34.84660262;2680
TLKM.JK;21/10/20;2680;2710;2670;2680;2461.325195;142146300;40;0;2740;2714.285714;2707.142857;45.82575695;2700
TLKM.JK;22/10/20;2670;2720;2650;2700;2479.693359;257179400;70;30;2732.857143;2709.285714;2702.380952;51.22313465;2630
TLKM.JK;23/10/20;2710;2720;2630;2630;2415.405029;166356000;90;-80;2728.571429;2710.714286;2697.619048;52.734736;2650
TLKM.JK;26/10/20;2630;2680;2630;2650;2433.773193;97523200;50;20;2702.857143;2709.285714;2692.857143;50.23753103;2620
TLKM.JK;27/10/20;2640;2690;2620;2620;2406.221191;146366600;70;-20;2684.285714;2709.285714;2690.952381;39.94043184;2560
TLKM.JK;02/11/20;2590;2620;2550;2560;2351.116699;391510600;70;-30;2665.714286;2706.428571;2689.047619;34.08672413;2580
TLKM.JK;03/11/20;2570;2590;2540;2580;2369.484863;188874000;50;10;2644.285714;2696.428571;2685.714286;46.49628761;2580
TLKM.JK;04/11/20;2600;2640;2580;2580;2369.484863;150678200;60;-20;2631.428571;2685.714286;2686.666667;50.47394424;2770
TLKM.JK;05/11/20;2630;2810;2620;2770;2543.981934;369260400;190;140;2617.142857;2675;2678.571429;48.55041562;2830
TLKM.JK;06/11/20;2800;2840;2750;2830;2599.085938;243865800;90;30;2627.142857;2677.857143;2682.857143;70.64330252;2880
TLKM.JK;09/11/20;2860;2900;2840;2880;2645.006348;208192700;60;20;2655.714286;2679.285714;2691.428571;104.3802572;2860
TLKM.JK;10/11/20;2950;2950;2860;2860;2626.638184;195337300;90;-90;2688.571429;2686.428571;2702.380952;134.2173078;3080
TLKM.JK;11/11/20;2900;3100;2880;3080;2828.6875;480530200;220;180;2722.857143;2694.285714;2711.904762;144.073394;3040
TLKM.JK;12/11/20;3080;3080;3010;3040;2791.951172;169609900;70;-40;2797.142857;2720.714286;2730;176.5138602;2990
TLKM.JK;13/11/20;3010;3010;2950;2990;2746.030762;186708800;60;-20;2862.857143;2747.142857;2744.761905;167.6021366;3070
TLKM.JK;16/11/20;3040;3100;3020;3070;2819.503418;206145500;80;30;2921.428571;2769.285714;2757.142857;115.9638696;3220
TLKM.JK;17/11/20;3100;3270;3100;3220;2957.26416;527501800;170;120;2964.285714;2795.714286;2773.333333;105.6499161;3180
TLKM.JK;18/11/20;3200;3250;3160;3180;2920.527832;239122600;90;-20;3020;2837.857143;2792.857143;124.2309677;3170
TLKM.JK;19/11/20;3150;3220;3140;3170;2911.34375;185558800;80;20;3062.857143;2875.714286;2811.904762;119.5427798;3220
TLKM.JK;20/11/20;3190;3270;3180;3220;2957.26416;211892500;90;30;3107.142857;2915;2831.904762;84.00680245;3320
TLKM.JK;23/11/20;3230;3340;3220;3320;3049.104492;260752200;120;90;3127.142857;2962.142857;2856.190476;92.68482179;3350
TLKM.JK;24/11/20;3350;3380;3330;3350;3076.656738;207503900;50;0;3167.142857;3015;2887.142857;107.9682493;3280
TLKM.JK;25/11/20;3370;3390;3280;3280;3012.368408;253156200;110;-90;3218.571429;3070;2919.047619;94.4154951;3470
TLKM.JK;26/11/20;3280;3480;3280;3470;3186.865234;374185400;200;190;3248.571429;3106.428571;2946.666667;69.38505397;3460
TLKM.JK;27/11/20;3480;3500;3420;3460;3177.681152;163651600;80;-20;3284.285714;3152.142857;2986.666667;106.5922359;3230
TLKM.JK;30/11/20;3460;3470;3220;3230;2966.448242;624142600;250;-230;3324.285714;3193.571429;3025.238095;113.2632837;3240
TLKM.JK;01/12/20;3230;3320;3160;3240;2975.63208;277929200;160;10;3332.857143;3220;3054.285714;101.2775536;3330
TLKM.JK;02/12/20;3270;3330;3240;3330;3058.288574;187276600;90;60;3335.714286;3231.428571;3086.666667;97.78499252;3300
TLKM.JK;03/12/20;3330;3360;3280;3300;3030.736328;121434200;80;-30;3337.142857;3252.142857;3122.380952;97.59000729;3250
TLKM.JK;04/12/20;3270;3280;3210;3250;2984.816162;170418900;70;-20;3330;3274.285714;3156.666667;98.31920803;3330
TLKM.JK;07/12/20;3280;3330;3260;3330;3058.288574;175436900;70;50;3325.714286;3287.142857;3179.52381;101.4654527;3300
TLKM.JK;08/12/20;3350;3350;3290;3300;3030.736328;113775100;60;-50;3305.714286;3295;3203.333333;79.7615494;3260
TLKM.JK;10/12/20;3270;3290;3250;3260;2994.000244;229380200;40;-10;3282.857143;3303.571429;3223.333333;42.31401884;3280
TLKM.JK;11/12/20;3270;3330;3250;3280;3012.368408;154365400;80;10;3287.142857;3310;3242.380952;37.28908943;3320
TLKM.JK;14/12/20;3300;3340;3250;3320;3049.104492;281474900;90;20;3292.857143;3314.285714;3251.904762;31.4718317;3450
TLKM.JK;15/12/20;3320;3490;3290;3450;3168.49707;410175700;200;130;3291.428571;3314.285714;3265.238095;29.68084199;3610
TLKM.JK;16/12/20;3500;3640;3500;3610;3315.441895;455088400;140;110;3312.857143;3321.428571;3287.142857;67.25927091;3540
TLKM.JK;17/12/20;3610;3620;3520;3540;3251.153809;249797800;100;-70;3364.285714;3345;3312.857143;124.4798702;3510
TLKM.JK;18/12/20;3500;3540;3500;3510;3223.601563;187856600;40;10;3394.285714;3350;3328.095238;139.2667875;3520
TLKM.JK;21/12/20;3530;3610;3510;3520;3232.785645;267970200;100;-10;3424.285714;3353.571429;3343.809524;138.1855206;3360
TLKM.JK;22/12/20;3500;3540;3340;3360;3085.84082;311860000;200;-140;3461.428571;3374.285714;3360.47619;120.4752494;3320
TLKM.JK;23/12/20;3350;3420;3240;3320;3049.104492;240067600;180;-30;3472.857143;3382.857143;3367.142857;102.9100393;3430
TLKM.JK;28/12/20;3370;3460;3280;3430;3150.12915;178138100;180;60;3472.857143;3382.142857;3367.142857;102.9100393;3420
TLKM.JK;29/12/20;3500;3530;3400;3420;3140.945068;184525500;130;-80;3470;3391.428571;3370.952381;103.9230485;3310
TLKM.JK;30/12/20;3420;3420;3310;3310;3039.92041;150844500;110;-110;3442.857143;3403.571429;3377.619048;84.20496536;3490
TLKM.JK;04/01/21;3320;3500;3310;3490;3205.233154;165339800;190;170;3410;3402.142857;3370;84.85281374;3470
TLKM.JK;05/01/21;3480;3480;3420;3470;3186.865234;157800700;60;-10;3407.142857;3415.714286;3371.428571;81.18174789;3370
TLKM.JK;06/01/21;3470;3490;3330;3370;3095.024902;177877900;160;-100;3400;3430.714286;3382.857143;71.18052168;3390
TLKM.JK;07/01/21;3390;3450;3380;3390;3113.392822;140221900;70;0;3401.428571;3437.142857;3389.047619;70.33931367;3570
TLKM.JK;08/01/21;3450;3620;3440;3570;3278.705811;492643700;180;120;3411.428571;3442.142857;3391.904762;61.21780009;3600
TLKM.JK;11/01/21;3590;3640;3570;3600;3306.257813;271231200;70;10;3431.428571;3450.714286;3404.761905;86.10624666;3510
TLKM.JK;12/01/21;3600;3620;3500;3510;3223.601563;189779500;120;-90;3457.142857;3450;3421.428571;106.5698966;3480
TLKM.JK;13/01/21;3550;3550;3460;3480;3196.049316;162329300;90;-70;3485.714286;3447.857143;3430;85.21681032;3500
TLKM.JK;14/01/21;3480;3590;3470;3500;3214.41748;187448400;120;20;3484.285714;3445.714286;3438.571429;85.21681032;3480
TLKM.JK;15/01/21;3510;3540;3450;3480;3196.049316;133304300;90;-30;3488.571429;3444.285714;3450;85.13294925;3450
TLKM.JK;18/01/21;3480;3520;3430;3450;3168.49707;138913100;90;-30;3504.285714;3452.857143;3459.52381;68.03360514;3410
TLKM.JK;19/01/21;3470;3490;3370;3410;3131.760986;144100700;120;-60;3512.857143;3462.142857;3465.714286;53.45224838;3470
TLKM.JK;20/01/21;3420;3480;3380;3470;3186.865234;116098100;100;50;3490;3460.714286;3463.809524;58.87840578;3480
TLKM.JK;21/01/21;3500;3520;3460;3480;3196.049316;81801900;60;-20;3471.428571;3464.285714;3457.142857;33.38091842;3390
TLKM.JK;22/01/21;3420;3440;3360;3390;3113.392822;165024200;80;-30;3467.142857;3476.428571;3454.285714;29.27700219;3370
TLKM.JK;25/01/21;3370;3410;3310;3370;3095.024902;118131800;100;0;3454.285714;3469.285714;3448.571429;40.35556255;3260
TLKM.JK;26/01/21;3360;3390;3260;3260;2994.000244;111414500;130;-100;3435.714286;3462.142857;3441.428571;45.40820148;3380
TLKM.JK;27/01/21;3340;3380;3260;3380;3104.208984;159144700;120;40;3404.285714;3454.285714;3436.666667;75.68732674;3240
TLKM.JK;28/01/21;3280;3330;3230;3240;2975.63208;142648800;100;-40;3394.285714;3453.571429;3439.52381;73.22502825;3110
TLKM.JK;29/01/21;3290;3290;3110;3110;2856.239502;191915100;180;-180;3370;3430;3430.47619;92.73618495;3230
TLKM.JK;01/02/21;3130;3250;3040;3230;2966.448242;133929600;210;100;3318.571429;3395;3415.714286;122.9401713;3270
TLKM.JK;02/02/21;3300;3330;3250;3270;3003.184326;114734600;80;-30;3282.857143;3375;3411.904762;102.9100393;3240
TLKM.JK;03/02/21;3250;3330;3220;3240;2975.63208;86433900;110;-10;3265.714286;3360;3401.428571;91.44345117;3290
TLKM.JK;04/02/21;3270;3330;3260;3290;3021.552246;80319500;70;20;3247.142857;3341.428571;3390.47619;79.102104;3290
TLKM.JK;05/02/21;3320;3320;3270;3290;3021.552246;52630500;50;-30;3251.428571;3327.857143;3386.666667;80.7111251;3280
TLKM.JK;08/02/21;3300;3370;3270;3280;3012.368408;96635600;100;-20;3238.571429;3316.428571;3381.904762;61.75990377;3200
TLKM.JK;09/02/21;3250;3300;3180;3200;2938.895996;157479200;120;-50;3244.285714;3307.142857;3368.095238;63.73307432;3190
TLKM.JK;10/02/21;3180;3220;3160;3190;2929.711914;125221400;60;10;3257.142857;3287.857143;3349.047619;34.50327797;3190
TLKM.JK;11/02/21;3220;3230;3170;3190;2929.711914;79940700;60;-30;3251.428571;3267.142857;3333.809524;42.20133151;3220
TLKM.JK;15/02/21;3200;3260;3200;3220;2957.26416;88883300;60;20;3240;3252.857143;3320;46.9041576;3210
TLKM.JK;16/02/21;3200;3250;3190;3210;2948.080078;82026300;60;10;3237.142857;3242.142857;3306.666667;47.50939757;3150
TLKM.JK;17/02/21;3220;3250;3140;3150;2892.975586;121105300;110;-70;3225.714286;3238.571429;3293.809524;41.97504928;3180
TLKM.JK;18/02/21;3190;3270;3180;3180;2920.527832;151200300;90;-10;3205.714286;3222.142857;3279.52381;39.5209408;3210
TLKM.JK;19/02/21;3180;3220;3170;3210;2948.080078;63214600;50;30;3191.428571;3217.857143;3268.571429;22.67786838;3170
TLKM.JK;22/02/21;3210;3240;3170;3170;2911.34375;100425500;70;-40;3192.857143;3225;3256.190476;23.60387377;3470
TLKM.JK;23/02/21;3200;3480;3200;3470;3186.865234;354966200;280;270;3190;3220.714286;3241.428571;25.16611478;3480
TLKM.JK;24/02/21;3490;3550;3460;3480;3196.049316;303017100;90;-10;3230;3235;3245.238095;108.7811258;3490
TLKM.JK;25/02/21;3510;3570;3450;3490;3205.233154;226833000;120;-20;3267.142857;3252.142857;3250.47619;143.6099214;3490
TLKM.JK;26/02/21;3450;3510;3410;3490;3205.233154;230007700;100;40;3307.142857;3266.428571;3261.428571;162.7589512;3490
TLKM.JK;01/03/21;3490;3510;3470;3490;3205.233154;91513500;40;0;3355.714286;3280.714286;3266.666667;158.7300794;3460
TLKM.JK;02/03/21;3490;3500;3440;3460;3177.681152;169061400;60;-30;3400;3295.714286;3278.571429;144.1064421;3440
TLKM.JK;03/03/21;3480;3480;3420;3440;3159.312988;82610700;60;-40;3435.714286;3314.285714;3295.238095;117.7365906;3360
TLKM.JK;04/03/21;3420;3430;3350;3360;3085.84082;142322100;80;-60;3474.285714;3332.142857;3305.238095;19.02379462;3320
TLKM.JK;05/03/21;3340;3370;3320;3320;3049.104492;128546000;50;-20;3458.571429;3344.285714;3309.52381;47.40906082;3340
TLKM.JK;08/03/21;3360;3400;3330;3340;3067.472412;80094900;70;-20;3435.714286;3351.428571;3313.333333;69.00655593;3290
TLKM.JK;09/03/21;3370;3390;3280;3290;3021.552246;110090800;110;-80;3414.285714;3360.714286;3315.714286;72.53898787;3400
TLKM.JK;10/03/21;3340;3420;3310;3400;3122.576904;91631900;110;60;3385.714286;3370.714286;3315.714286;76.99721702;3450
TLKM.JK;12/03/21;3440;3480;3430;3450;3168.49707;100195200;50;10;3372.857143;3386.428571;3321.428571;62.9058253;3380
TLKM.JK;15/03/21;3440;3450;3380;3380;3104.208984;50077300;70;-60;3371.428571;3403.571429;3333.333333;60.67085281;3360
TLKM.JK;16/03/21;3400;3410;3360;3360;3085.84082;60111200;50;-40;3362.857143;3418.571429;3342.380952;53.13952883;3390
TLKM.JK;17/03/21;3410;3430;3370;3390;3113.392822;61701400;60;-20;3362.857143;3410.714286;3350.47619;53.13952883;3450
TLKM.JK;18/03/21;3450;3480;3430;3450;3168.49707;101896400;50;0;3372.857143;3404.285714;3358.571429;50.23753103;3440
TLKM.JK;19/03/21;3410;3440;3380;3440;3159.312988;140000000;60;30;3388.571429;3401.428571;3370;55.20524475;3380
TLKM.JK;22/03/21;3440;3440;3380;3380;3104.208984;53870300;60;-60;3410;3397.857143;3383.809524;36.51483717;3360
TLKM.JK;23/03/21;3390;3420;3350;3360;3085.84082;55323200;70;-30;3407.142857;3390;3393.333333;38.17254062;3370
TLKM.JK;24/03/21;3320;3390;3320;3370;3095.024902;67173200;70;50;3394.285714;3382.857143;3400.47619;36.44957378;3410
TLKM.JK;25/03/21;3400;3430;3380;3410;3131.760986;107607200;50;10;3392.857143;3377.857143;3410;37.28908943;3490
TLKM.JK;26/03/21;3410;3500;3390;3490;3205.233154;106810400;110;80;3400;3381.428571;3407.142857;34.64101615;3410
TLKM.JK;29/03/21;3470;3490;3400;3410;3131.760986;72214100;90;-60;3414.285714;3393.571429;3407.619048;47.90864322;3380
TLKM.JK;30/03/21;3420;3430;3360;3380;3104.208984;66491800;70;-40;3408.571429;3398.571429;3403.809524;45.25062483;3420
TLKM.JK;31/03/21;3380;3420;3330;3420;3140.945068;134671900;90;40;3400;3405;3398.571429;43.96968653;3390
TLKM.JK;01/04/21;3390;3440;3380;3390;3113.392822;73332000;60;0;3405.714286;3406.428571;3395.238095;43.53433237;3380
TLKM.JK;05/04/21;3430;3430;3370;3380;3104.208984;36029200;60;-50;3410;3402.142857;3391.904762;39.58114029;3370
TLKM.JK;06/04/21;3400;3410;3370;3370;3095.024902;40566400;40;-30;3411.428571;3402.142857;3389.047619;38.04758925;3400
TLKM.JK;07/04/21;3410;3430;3380;3400;3122.576904;84754300;50;-10;3405.714286;3402.857143;3389.52381;41.17326918;3390
TLKM.JK;08/04/21;3380;3400;3380;3390;3113.392822;59079700;20;10;3392.857143;3403.571429;3393.333333;17.99470822;3360
TLKM.JK;09/04/21;3390;3390;3360;3360;3085.84082;56861400;30;-30;3390;3399.285714;3395.714286;16.32993162;3310
TLKM.JK;12/04/21;3340;3390;3300;3310;3039.92041;79003200;90;-30;3387.142857;3393.571429;3399.047619;19.7604704;3330
TLKM.JK;13/04/21;3340;3340;3300;3330;3058.288574;51300200;40;-10;3371.428571;3388.571429;3394.761905;30.23715784;3340
TLKM.JK;14/04/21;3360;3360;3320;3340;3067.472412;52587500;40;-20;3362.857143;3386.428571;3389.047619;32.51373336;3360
TLKM.JK;15/04/21;3340;3360;3320;3360;3085.84082;65669100;40;20;3357.142857;3384.285714;3387.142857;32.51373336;3360
TLKM.JK;16/04/21;3370;3370;3320;3360;3085.84082;52517800;50;-10;3355.714286;3380.714286;3387.142857;32.07134903;3340
TLKM.JK;19/04/21;3330;3360;3330;3340;3067.472412;44899700;30;10;3350;3371.428571;3385.714286;25.81988897;3320
TLKM.JK;20/04/21;3330;3350;3300;3320;3049.104492;55700100;50;-10;3342.857143;3366.428571;3380.47619;18.89822365;3280
TLKM.JK;21/04/21;3290;3330;3280;3280;3012.368408;47167800;50;-10;3337.142857;3362.142857;3374.761905;18.89822365;3330
TLKM.JK;22/04/21;3290;3340;3290;3330;3058.288574;54970000;50;40;3332.857143;3352.142857;3370;27.51622898;3310
TLKM.JK;23/04/21;3330;3330;3290;3310;3039.92041;39798400;40;-20;3332.857143;3347.857143;3368.571429;27.51622898;3250
TLKM.JK;26/04/21;3280;3300;3250;3250;2984.816162;55076200;50;-30;3328.571429;3342.857143;3365.714286;28.53569194;3160
TLKM.JK;27/04/21;3240;3250;3140;3160;2902.159668;166985400;110;-80;3312.857143;3334.285714;3358.095238;37.28908943;3140
TLKM.JK;28/04/21;3160;3170;3130;3140;2883.791504;91596300;40;-20;3284.285714;3317.142857;3342.380952;62.9436634;3200
TLKM.JK;29/04/21;3150;3210;3140;3200;2938.895996;111785100;70;50;3255.714286;3299.285714;3329.52381;77.21337165;3200
TLKM.JK;30/04/21;3220;3260;3200;3200;2938.895996;143840800;60;-20;3238.571429;3287.857143;3320.952381;73.8079877;3170
TLKM.JK;03/05/21;3200;3210;3130;3170;2911.34375;124724400;80;-30;3227.142857;3280;3310.47619;72.50615737;3210
TLKM.JK;04/05/21;3180;3210;3170;3210;2948.080078;60180600;40;30;3204.285714;3268.571429;3300;58.55400438;3200
TLKM.JK;05/05/21;3210;3210;3180;3200;2938.895996;76480300;30;-10;3190;3259.285714;3291.904762;36.51483717;3190
TLKM.JK;06/05/21;3200;3200;3150;3190;2929.711914;91955600;50;-10;3182.857143;3247.857143;3283.809524;26.27691364;3190
TLKM.JK;07/05/21;3200;3220;3180;3190;2929.711914;98099900;40;-10;3187.142857;3235.714286;3273.809524;24.29971585;3170
TLKM.JK;10/05/21;3190;3200;3160;3170;2911.34375;104121900;40;-20;3194.285714;3225;3264.285714;12.72418021;3180
TLKM.JK;11/05/21;3170;3200;3150;3180;2920.527832;94281900;50;10;3190;3214.285714;3255.238095;15.27525232;3190
TLKM.JK;17/05/21;3190;3190;3150;3190;2929.711914;114071400;40;0;3187.142857;3207.142857;3249.047619;14.96026483;3180
TLKM.JK;18/05/21;3190;3190;3150;3180;2920.527832;77310400;40;-10;3190;3197.142857;3242.380952;12.90994449;3160
TLKM.JK;19/05/21;3150;3220;3150;3160;2902.159668;48958100;70;10;3185.714286;3187.857143;3234.761905;9.759000729;3310
TLKM.JK;20/05/21;3190;3320;3180;3310;3039.92041;197430900;140;120;3180;3181.428571;3225.238095;11.54700538;3270
TLKM.JK;21/05/21;3340;3350;3270;3270;3003.184326;104101400;80;-70;3197.142857;3192.142857;3222.857143;50.89672082;3260
TLKM.JK;24/05/21;3290;3330;3220;3260;2994.000244;64347100;110;-30;3208.571429;3201.428571;3219.52381;57.56983337;3300
TLKM.JK;25/05/21;3290;3320;3270;3300;3030.736328;62218300;50;10;3221.428571;3205.714286;3216.666667;57.56983337;3380
TLKM.JK;27/05/21;3350;3400;3330;3380;3104.208984;233551300;70;30;3238.571429;3212.857143;3217.619048;60.94494002;3270
TLKM.JK;28/05/21;3380;3400;3260;3270;3003.184326;87439800;140;-110;3265.714286;3227.857143;3220;76.1264612;3440
TLKM.JK;31/05/21;3300;3460;3300;3440;3159.312988;155768200;160;140;3278.571429;3232.142857;3218.095238;66.18876325;3450
TLKM.JK;02/06/21;3490;3500;3420;3450;3168.49707;108933400;80;-40;3318.571429;3249.285714;3227.142857;67.18843438;3490
TLKM.JK;03/06/21;3420;3490;3420;3490;3205.233154;77627900;70;70;3338.571429;3267.857143;3240.952381;83.15218406;3500
TLKM.JK;04/06/21;3490;3510;3450;3500;3214.41748;70624200;60;10;3370;3289.285714;3257.619048;93.8083152;3550
TLKM.JK;07/06/21;3540;3570;3500;3550;3260.337646;124440300;70;10;3404.285714;3312.857143;3271.904762;90.71147352;3500
TLKM.JK;08/06/21;3550;3550;3470;3500;3214.41748;132409400;80;-50;3440;3339.285714;3288.571429;92.01449161;3390
TLKM.JK;09/06/21;3340;3400;3310;3390;3270.380371;112204200;90;50;3457.142857;3361.428571;3304.285714;90.13217807;3480
TLKM.JK;10/06/21;3350;3500;3340;3480;3357.20459;137713700;160;130;3474.285714;3376.428571;3312.857143;51.91568256;3470
TLKM.JK;11/06/21;3490;3500;3420;3470;3347.557617;82336600;80;-20;3480;3399.285714;3326.190476;49.66554809;3410
TLKM.JK;14/06/21;3460;3470;3400;3410;3289.674805;46016500;70;-50;3482.857143;3410.714286;3339.52381;48.20590756;3440
TLKM.JK;15/06/21;3410;3440;3380;3440;3318.616211;60528600;60;30;3471.428571;3420.714286;3350;55.20524475;3410
TLKM.JK;16/06/21;3380;3430;3380;3410;3289.674805;39149800;50;30;3462.857143;3433.571429;3362.857143;54.68524655;3350
TLKM.JK;17/06/21;3370;3420;3350;3350;3231.791748;50286100;70;-20;3442.857143;3441.428571;3373.809524;41.51878519;3350
TLKM.JK;18/06/21;3350;3400;3290;3350;3231.791748;168414300;110;0;3421.428571;3439.285714;3381.428571;45.61745698;3300
TLKM.JK;21/06/21;3280;3340;3260;3300;3183.556152;74248200;80;20;3415.714286;3445;3389.52381;52.23572943;3300
TLKM.JK;22/06/21;3300;3370;3290;3300;3183.556152;89349200;80;0;3390;3435;3396.190476;59.16079783;3370
TLKM.JK;23/06/21;3310;3420;3310;3370;3251.086182;81901000;110;60;3365.714286;3424.285714;3395.714286;55.63486403;3250
TLKM.JK;24/06/21;3330;3360;3240;3250;3135.320557;101334200;120;-80;3360;3415.714286;3400.47619;52.28129047;3250
TLKM.JK;25/06/21;3250;3300;3240;3250;3135.320557;58330700;60;0;3332.857143;3397.857143;3400;53.13952883;3170
TLKM.JK;28/06/21;3250;3260;3170;3170;3058.143311;66338900;90;-80;3310;3376.428571;3397.619048;48.6483984;3160
TLKM.JK;29/06/21;3190;3260;3150;3160;3048.496094;123411200;110;-30;3284.285714;3352.857143;3387.619048;67.78818551;3150
TLKM.JK;30/06/21;3150;3180;3130;3150;3038.849121;142204500;50;0;3257.142857;3336.428571;3382.380952;74.76948703;3110
TLKM.JK;01/07/21;3160;3170;3090;3110;3000.260498;143665900;80;-50;3235.714286;3312.857143;3368.571429;81.62049229;3070
TLKM.JK;02/07/21;3110;3130;3060;3070;2961.671875;161855700;70;-40;3208.571429;3287.142857;3352.380952;88.02056037;3040
TLKM.JK;05/07/21;3070;3090;3010;3040;2932.730469;133815000;80;-30;3165.714286;3262.857143;3332.380952;66.79749069;3010
TLKM.JK;06/07/21;3050;3070;3000;3010;2903.789063;151573500;70;-40;3135.714286;3234.285714;3310.47619;69.72736021;3030
TLKM.JK;07/07/21;3030;3070;3010;3030;2923.083496;110215500;60;0;3101.428571;3205.714286;3284.761905;62.83008075;3010
TLKM.JK;08/07/21;3060;3060;3000;3010;2903.789063;132576600;60;-50;3081.428571;3182.857143;3262.380952;59.56189258;3160
TLKM.JK;09/07/21;3040;3170;3030;3160;3048.496094;222916400;140;120;3060;3158.571429;3244.285714;53.22906474;3130
TLKM.JK;12/07/21;3190;3190;3110;3130;3019.554688;86268000;80;-60;3061.428571;3148.571429;3229.047619;56.10364558;3070
TLKM.JK;13/07/21;3160;3160;3050;3070;2961.671875;82856600;110;-90;3064.285714;3136.428571;3212.857143;59.40177968;3060
TLKM.JK;14/07/21;3050;3070;3020;3060;2952.024902;84993400;50;10;3064.285714;3115;3196.666667;59.40177968;3130
TLKM.JK;15/07/21;3110;3140;3080;3130;3019.554688;88092800;60;20;3067.142857;3101.428571;3178.571429;58.51332775;3170
TLKM.JK;16/07/21;3140;3170;3110;3170;3058.143311;63626300;60;30;3084.285714;3092.857143;3165.238095;56.52643714;3220
TLKM.JK;19/07/21;3160;3230;3150;3220;3106.37915;116219500;80;60;3104.285714;3092.857143;3156.666667;58.83795341;3210
TLKM.JK;21/07/21;3190;3240;3180;3210;3096.731934;115099400;60;20;3134.285714;3097.142857;3150.47619;56.23081683;3260
TLKM.JK;22/07/21;3210;3260;3210;3260;3144.967529;48865700;50;50;3141.428571;3101.428571;3146.190476;62.83008075;3170
TLKM.JK;23/07/21;3250;3250;3150;3170;3058.143311;67128400;100;-80;3160;3112.142857;3144.285714;76.59416862;3190
TLKM.JK;26/07/21;3140;3200;3140;3190;3077.437744;55525800;60;50;3174.285714;3119.285714;3134.761905;65.538066;3270
TLKM.JK;27/07/21;3210;3270;3160;3270;3154.614746;62673400;110;60;3192.857143;3130;3131.904762;41.91828786;3190
TLKM.JK;28/07/21;3250;3250;3150;3190;3077.437744;103282300;100;-60;3212.857143;3148.571429;3132.857143;40.29652;3230
TLKM.JK;29/07/21;3210;3290;3200;3230;3116.026123;126542400;90;20;3215.714286;3160;3133.809524;37.35288604;3240
TLKM.JK;30/07/21;3200;3290;3200;3240;3125.67334;95143100;90;40;3217.142857;3175.714286;3137.142857;37.73340064;3310
TLKM.JK;02/08/21;3240;3310;3210;3310;3193.203369;60368200;100;70;3221.428571;3181.428571;3141.428571;38.48314411;3330
TLKM.JK;03/08/21;3310;3360;3290;3330;3212.497559;89712500;70;20;3228.571429;3194.285714;3150.952381;49.80915961;3370
TLKM.JK;04/08/21;3330;3370;3310;3370;3251.086182;63108600;60;40;3251.428571;3212.857143;3163.333333;54.902511;3340
TLKM.JK;05/08/21;3360;3400;3320;3340;3222.144775;89742800;80;-20;3277.142857;3235;3179.047619;62.9058253;3320
TLKM.JK;06/08/21;3360;3380;3310;3320;3202.850342;31664200;70;-40;3287.142857;3250;3194.761905;67.01101544;3250
TLKM.JK;09/08/21;3260;3300;3220;3250;3135.320557;70299500;80;-10;3305.714286;3260.714286;3208.571429;51.91568256;3230
TLKM.JK;10/08/21;3240;3270;3190;3230;3116.026123;57658000;80;-10;3308.571429;3262.857143;3220;47.40906082;3350
TLKM.JK;12/08/21;3260;3350;3240;3350;3231.791748;93133400;110;90;3307.142857;3264.285714;3223.333333;49.90467103;3300
TLKM.JK;13/08/21;3370;3380;3260;3300;3183.556152;59903600;120;-70;3312.857143;3270.714286;3233.809524;52.50850271;3340
TLKM.JK;16/08/21;3300;3340;3290;3340;3222.144775;38661800;50;40;3308.571429;3280;3244.761905;52.09880723;3420
TLKM.JK;18/08/21;3360;3440;3350;3420;3299.321777;162921300;90;60;3304.285714;3290.714286;3258.095238;47.20774755;3390
TLKM.JK;19/08/21;3410;3430;3360;3390;3270.380371;100851800;70;-20;3315.714286;3301.428571;3271.904762;63.99404734;3400
TLKM.JK;20/08/21;3390;3430;3370;3400;3280.027588;113411000;60;10;3325.714286;3315.714286;3282.380952;69.96597813;3440
TLKM.JK;23/08/21;3420;3440;3400;3440;3318.616211;64122400;40;20;3347.142857;3327.857143;3290.952381;65.75568054;3400
TLKM.JK;24/08/21;3410;3420;3310;3400;3280.027588;69338100;110;-10;3377.142857;3342.142857;3301.904762;49.23220007;3370
TLKM.JK;25/08/21;3390;3390;3330;3370;3251.086182;66618200;60;-20;3384.285714;3348.571429;3308.571429;48.25527358;3360
TLKM.JK;26/08/21;3330;3360;3320;3360;3241.438965;55756100;40;30;3394.285714;3351.428571;3318.095238;32.58688021;3320
TLKM.JK;27/08/21;3370;3370;3310;3320;3202.850342;62419000;60;-50;3397.142857;3350.714286;3326.190476;27.51622898;3400
TLKM.JK;30/08/21;3330;3400;3330;3400;3280.027588;64177700;70;70;3382.857143;3349.285714;3328.571429;37.73340064;3400
TLKM.JK;31/08/21;3400;3420;3360;3400;3280.027588;130019000;60;0;3384.285714;3355;3338.571429;38.23486317;3340
TLKM.JK;01/09/21;3420;3420;3330;3340;3222.144775;85135200;90;-80;3384.285714;3365.714286;3346.666667;38.23486317;3370
TLKM.JK;02/09/21;3350;3390;3350;3370;3251.086182;51633800;40;20;3370;3373.571429;3351.428571;32.14550254;3390
TLKM.JK;03/09/21;3400;3420;3370;3390;3270.380371;65479800;50;-10;3365.714286;3375;3354.285714;29.35821456;3390
TLKM.JK;06/09/21;3410;3410;3380;3390;3270.380371;52640400;30;-20;3368.571429;3381.428571;3357.142857;30.78342164;3380
TLKM.JK;07/09/21;3410;3410;3360;3380;3260.733398;42617400;50;-30;3372.857143;3385;3358.095238;31.4718317;3330
TLKM.JK;08/09/21;3400;3400;3310;3330;3212.497559;80636800;90;-70;3381.428571;3382.142857;3360;21.15700942;3390
TLKM.JK;09/09/21;3360;3390;3330;3390;3270.380371;82214400;60;30;3371.428571;3377.857143;3360.47619;26.72612419;3330
TLKM.JK;10/09/21;3380;3390;3320;3330;3212.497559;52115300;70;-50;3370;3377.142857;3367.142857;25.16611478;3350
TLKM.JK;13/09/21;3310;3350;3300;3350;3231.791748;45547200;50;40;3368.571429;3369.285714;3371.904762;27.34262328;3440
TLKM.JK;14/09/21;3380;3450;3350;3440;3318.616211;166002100;100;60;3365.714286;3365.714286;3371.904762;28.19996623;3450
TLKM.JK;15/09/21;3430;3450;3410;3450;3328.263184;73158300;40;20;3372.857143;3370.714286;3378.571429;39.46064948;3440
TLKM.JK;16/09/21;3470;3470;3400;3440;3318.616211;58318700;70;-30;3381.428571;3377.142857;3383.809524;49.13538149;3530
TLKM.JK;17/09/21;3400;3530;3390;3530;3405.44043;117573100;140;130;3390;3385.714286;3384.761905;53.85164807;3520
TLKM.JK;20/09/21;3500;3520;3460;3520;3395.793213;83985100;60;20;3418.571429;3395;3391.428571;67.92853387;3530
TLKM.JK;21/09/21;3500;3560;3480;3530;3405.44043;95848100;80;30;3437.142857;3403.571429;3397.142857;76.0951785;3590
TLKM.JK;22/09/21;3530;3590;3520;3590;3463.323242;66835200;70;60;3465.714286;3417.142857;3401.428571;66.0447179;3560
TLKM.JK;23/09/21;3600;3610;3550;3560;3434.381836;104737500;60;-40;3500;3432.857143;3410.47619;57.73502692;3560
TLKM.JK;24/09/21;3560;3580;3540;3560;3434.381836;72224500;40;0;3517.142857;3445;3419.52381;54.68524655;3520
TLKM.JK;27/09/21;3530;3560;3480;3520;3395.793213;87303000;80;-10;3532.857143;3457.142857;3429.047619;47.50939757;3530
TLKM.JK;28/09/21;3510;3540;3490;3530;3405.44043;54671700;50;20;3544.285714;3467.142857;3438.571429;26.367368;3530
TLKM.JK;29/09/21;3490;3540;3490;3530;3405.44043;53170100;50;40;3544.285714;3481.428571;3444.761905;26.367368;3690
TLKM.JK;30/09/21;3550;3690;3540;3690;3559.794678;153853900;150;140;3545.714286;3491.428571;3450.952381;25.07132682;3660
TLKM.JK;01/10/21;3680;3690;3610;3660;3530.853271;109898400;80;-20;3568.571429;3517.142857;3467.619048;58.71642911;3670
TLKM.JK;04/10/21;3620;3670;3600;3670;3540.500244;82205100;70;50;3578.571429;3539.285714;3481.428571;68.17344826;3670
TLKM.JK;05/10/21;3670;3680;3620;3670;3540.500244;140488300;60;0;3594.285714;3555.714286;3494.761905;75.46680128;3760
TLKM.JK;06/10/21;3690;3770;3650;3760;3627.324707;153535700;120;70;3610;3571.428571;3508.095238;78.5281266;3720
TLKM.JK;07/10/21;3720;3740;3690;3720;3588.736084;56837600;50;0;3644.285714;3594.285714;3526.190476;84.82474931;3800
TLKM.JK;08/10/21;3730;3800;3720;3800;3665.913086;91361800;80;70;3671.428571;3607.857143;3544.761905;71.51423435;3810
TLKM.JK;11/10/21;3800;3850;3770;3810;3675.560303;78865000;80;10;3710;3627.857143;3564.285714;52.91502622;3780
TLKM.JK;12/10/21;3780;3840;3770;3780;3646.618896;69866300;70;0;3727.142857;3647.857143;3587.142857;63.69570517;3770
TLKM.JK;13/10/21;3750;3820;3750;3770;3636.97168;87143900;70;20;3744.285714;3661.428571;3607.619048;58.55400438;3830
TLKM.JK;14/10/21;3770;3830;3770;3830;3694.854492;95817900;60;60;3758.571429;3676.428571;3623.333333;48.79500365;3810
TLKM.JK;15/10/21;3840;3840;3750;3810;3675.560303;69707700;90;-30;3781.428571;3695.714286;3641.428571;36.25307869;3790
TLKM.JK;18/10/21;3840;3840;3790;3790;3656.266113;78580700;50;-50;3788.571429;3716.428571;3659.047619;36.25307869;3740
TLKM.JK;19/10/21;3750;3800;3720;3740;3608.030273;61095700;80;-10;3798.571429;3735;3671.428571;20.35400978;3850
TLKM.JK;21/10/21;3780;3880;3760;3850;3714.148926;169659500;120;70;3790;3750;3681.904762;30;3870
TLKM.JK;22/10/21;3860;3880;3820;3870;3733.443115;59640700;60;10;3795.714286;3761.428571;3697.142857;37.35288604;3780
TLKM.JK;25/10/21;3800;3840;3780;3780;3646.618896;58246300;60;-20;3808.571429;3776.428571;3710.47619;45.61745698;3800
TLKM.JK;26/10/21;3800;3830;3780;3800;3665.913086;58615100;50;0;3810;3784.285714;3720.952381;44.34711565;3790
TLKM.JK;27/10/21;3820;3830;3770;3790;3656.266113;52210100;60;-30;3805.714286;3793.571429;3732.380952;43.53433237;3750
TLKM.JK;28/10/21;3820;3820;3710;3750;3617.67749;61151100;110;-70;3802.857143;3795.714286;3745.238095;43.8612531;3800
TLKM.JK;29/10/21;3750;3810;3730;3800;3665.913086;70430900;80;50;3797.142857;3797.857143;3755.714286;48.20590756;3700
TLKM.JK;01/11/21;3810;3820;3700;3700;3569.44165;65447100;120;-110;3805.714286;3797.857143;3768.571429;41.17326918;3660
TLKM.JK;02/11/21;3700;3710;3640;3660;3530.853271;170260000;70;-40;3784.285714;3790;3769.047619;51.91568256;3720
TLKM.JK;03/11/21;3620;3740;3620;3720;3588.736084;48810500;120;100;3754.285714;3781.428571;3769.047619;54.72876844;3770
TLKM.JK;04/11/21;3750;3780;3720;3770;3636.97168;53494200;60;20;3745.714286;3777.857143;3771.428571;54.72876844;3770
TLKM.JK;05/11/21;3760;3770;3710;3770;3636.97168;43133000;60;10;3741.428571;3773.571429;3776.190476;50.80307452;3750
TLKM.JK;08/11/21;3780;3780;3710;3750;3617.67749;58758600;70;-30;3738.571429;3770.714286;3776.666667;48.10702354;3710
TLKM.JK;09/11/21;3730;3740;3680;3710;3579.088867;92427800;60;-20;3738.571429;3767.857143;3778.095238;48.10702354;3700
TLKM.JK;10/11/21;3670;3720;3670;3700;3569.44165;53511200;50;30;3725.714286;3765.714286;3773.809524;40.35556255;3650
TLKM.JK;11/11/21;3700;3730;3640;3650;3521.206055;95789600;90;-50;3725.714286;3755;3768.571429;40.35556255;3600
TLKM.JK;12/11/21;3660;3660;3600;3600;3472.970459;115142400;60;-60;3724.285714;3739.285714;3762.380952;43.14979446;3600
TLKM.JK;15/11/21;3600;3650;3600;3600;3472.970459;91001800;50;0;3707.142857;3726.428571;3754.285714;63.95683068;3670
TLKM.JK;16/11/21;3590;3680;3590;3670;3540.500244;99590700;90;80;3682.857143;3712.142857;3743.333333;68.24326236;3630
TLKM.JK;17/11/21;3690;3690;3600;3630;3501.911865;82023300;90;-60;3668.571429;3703.571429;3736.666667;56.39993246;3630
TLKM.JK;18/11/21;3630;3640;3600;3630;3501.911865;53290400;40;0;3651.428571;3695;3729.047619;44.50789122;3900
TLKM.JK;19/11/21;3660;3920;3660;3900;3762.384521;310615000;260;240;3640;3682.857143;3723.809524;36.51483717;3800
TLKM.JK;22/11/21;3920;3930;3780;3800;3665.913086;206683100;150;-120;3668.571429;3697.142857;3726.190476;105.1076546;3800
TLKM.JK;23/11/21;3800;3850;3780;3800;3665.913086;67778800;70;0;3690;3707.142857;3722.857143;115.4700538;3800
TLKM.JK;24/11/21;3840;3840;3790;3800;3665.913086;67303800;50;-40;3718.571429;3712.857143;3723.809524;114.226175;4000
TLKM.JK;25/11/21;3880;4090;3850;4000;3858.855957;264897100;240;120;3747.142857;3715;3723.809524;104.1976145;4010
TLKM.JK;26/11/21;4040;4050;3970;4010;3868.503174;231870300;80;-30;3794.285714;3731.428571;3733.809524;133.8976155;4140
TLKM.JK;29/11/21;4010;4170;3980;4140;3993.916016;228774600;190;130;3848.571429;3750;3746.190476;133.2201901;3990
TLKM.JK;30/11/21;4150;4170;3990;3990;3849.20874;435800600;180;-160;3921.428571;3780.714286;3762.380952;133.2201901;4080
TLKM.JK;01/12/21;4040;4150;4020;4080;3936.033203;200699200;130;40;3934.285714;3801.428571;3776.190476;135.1366152;4160
TLKM.JK;02/12/21;4140;4190;4100;4160;4013.210205;116093100;90;20;3974.285714;3832.142857;3796.190476;130.1098437;4070
TLKM.JK;03/12/21;4130;4180;4050;4070;3926.385986;96760700;130;-60;4025.714286;3872.142857;3817.142857;120.5345238;4170
TLKM.JK;06/12/21;4060;4250;4050;4170;4022.857422;106756900;200;110;4064.285714;3905.714286;3831.428571;68.03360514;4150
TLKM.JK;07/12/21;4180;4200;4120;4150;4003.562988;121543400;80;-30;4088.571429;3941.428571;3850.47619;71.51423435;4090
TLKM.JK;08/12/21;4100;4120;4010;4090;3945.680176;113845600;110;-10;4108.571429;3978.571429;3869.52381;65.17376042;4150
TLKM.JK;09/12/21;4090;4150;4080;4150;4003.562988;86985800;70;60;4101.428571;4011.428571;3887.619048;63.88233231;4150
TLKM.JK;10/12/21;4070;4150;4070;4150;4003.562988;90725000;80;80;4124.285714;4029.285714;3909.047619;42.37025012;4080
TLKM.JK;13/12/21;4150;4150;4080;4080;3936.033203;65533000;70;-70;4134.285714;4054.285714;3932.857143;38.23486317;4100
TLKM.JK;14/12/21;4120;4120;4070;4100;3955.327393;75736900;50;-20;4122.857143;4074.285714;3955.714286;41.11540089;4080
TLKM.JK;15/12/21;4060;4140;4060;4080;3936.033203;84424500;80;20;4127.142857;4095.714286;3979.52381;35.9231985;4100
TLKM.JK;16/12/21;4110;4150;4060;4100;3955.327393;98164300;90;-10;4114.285714;4101.428571;3999.047619;34.08672413;4100
TLKM.JK;17/12/21;4010;4100;4010;4100;3955.327393;149615800;90;90;4107.142857;4107.857143;4021.428571;30.39423504;4080
TLKM.JK;20/12/21;4070;4110;4040;4080;3936.033203;72794200;70;10;4108.571429;4105;4043.809524;29.68084199;4160
TLKM.JK;21/12/21;4110;4190;4100;4160;4013.210205;98039300;90;50;4098.571429;4111.428571;4052.380952;24.78478796;4110
TLKM.JK;22/12/21;4160;4170;4110;4110;3964.974609;50574500;60;-50;4100;4117.142857;4069.52381;28.28427125;4160
TLKM.JK;23/12/21;4110;4160;4100;4160;4013.210205;54508200;60;50;4104.285714;4113.571429;4084.285714;26.99206233;4110
TLKM.JK;24/12/21;4160;4170;4100;4110;3964.974609;29075600;70;-50;4112.857143;4120;4101.428571;34.01680257;4080
TLKM.JK;27/12/21;4150;4150;4070;4080;3936.033203;30748000;80;-70;4117.142857;4115.714286;4106.666667;30.93772547;4090
TLKM.JK;28/12/21;4080;4130;4050;4090;3945.680176;39443300;80;10;4114.285714;4110.714286;4110;33.59421719;4080
TLKM.JK;29/12/21;4100;4130;4080;4080;3936.033203;25596100;50;-20;4112.857143;4110.714286;4107.619048;34.50327797;4040
TLKM.JK;30/12/21;4130;4130;4040;4040;3897.44458;50575100;90;-90;4112.857143;4105.714286;4111.904762;34.50327797;4180
TLKM.JK;03/01/22;4060;4180;4050;4180;4032.504395;65937900;130;120;4095.714286;4097.857143;4110;36.90399385;4170
TLKM.JK;04/01/22;4180;4200;4150;4170;4022.857422;42984700;50;-10;4105.714286;4105;4110.952381;48.94116974;4050
TLKM.JK;05/01/22;4150;4190;4030;4050;3907.091553;119584700;160;-100;4107.142857;4110;4115.714286;50.89672082;4120
TLKM.JK;06/01/22;4090;4120;4030;4120;3974.621582;89197500;90;30;4098.571429;4107.857143;4110;55.20524475;4170
TLKM.JK;07/01/22;4120;4190;4090;4170;4022.857422;68415100;100;50;4104.285714;4109.285714;4108.571429;55.03245796;4100
TLKM.JK;10/01/22;4180;4190;4100;4100;3955.327393;44921200;90;-80;4115.714286;4114.285714;4112.380952;59.68169537;4090
TLKM.JK;11/01/22;4120;4160;4090;4090;3945.680176;61890200;70;-30;4118.571429;4115.714286;4110;58.14595756;4110
TLKM.JK;12/01/22;4110;4140;4070;4110;3964.974609;45132700;70;0;4125.714286;4110.714286;4107.142857;49.28053803;4180
TLKM.JK;13/01/22;4170;4180;4110;4180;4032.504395;84148400;70;10;4115.714286;4110.714286;4108.571429;43.14979446;4190
TLKM.JK;14/01/22;4140;4190;4130;4190;4042.151611;28193100;60;50;4117.142857;4112.142857;4112.380952;45.35573676;4180
TLKM.JK;17/01/22;4200;4200;4140;4180;4032.504395;39816300;60;-20;4137.142857;4117.857143;4117.619048;41.51878519;4250
TLKM.JK;18/01/22;4200;4250;4160;4250;4100.034668;112212200;90;50;4145.714286;4125;4121.428571;43.53433237;4250
TLKM.JK;19/01/22;4260;4260;4230;4250;4100.034668;88713900;30;-10;4157.142857;4136.428571;4128.571429;58.79747322;4220
TLKM.JK;20/01/22;4300;4300;4190;4220;4071.093018;100014500;110;-80;4178.571429;4148.571429;4136.666667;61.75990377;4330
TLKM.JK;21/01/22;4240;4330;4190;4330;4177.211426;75534800;140;90;4197.142857;4161.428571;4139.52381;48.89249626;4300
TLKM.JK;24/01/22;4260;4310;4250;4300;4148.27002;70404500;60;40;4228.571429;4172.142857;4150;53.98412465;4290
TLKM.JK;25/01/22;4310;4320;4250;4290;4138.623047;116353600;70;-20;4245.714286;4181.428571;4156.666667;55.03245796;4390
TLKM.JK;26/01/22;4380;4390;4290;4390;4235.094238;127641400;100;10;4260;4198.571429;4165.238095;50.99019514;4270
TLKM.JK;27/01/22;4400;4400;4260;4270;4119.328613;98613900;140;-130;4290;4217.857143;4180;57.44562647;4260
TLKM.JK;28/01/22;4260;4300;4230;4260;4109.681641;61686700;70;0;4292.857143;4225;4188.571429;55.5920515;4190
TLKM.JK;31/01/22;4210;4250;4190;4190;4042.151611;88735900;60;-20;4294.285714;4236.428571;4197.142857;54.42338433;4170
TLKM.JK;02/02/22;4170;4200;4150;4170;4022.857422;144006000;50;0;4290;4243.571429;4204.285714;61.91391874;4200
TLKM.JK;03/02/22;4200;4210;4160;4200;4051.798828;58212400;50;0;4267.142857;4247.857143;4203.809524;73.19250547;4230
TLKM.JK;04/02/22;4260;4260;4180;4230;4080.740234;98728700;80;-30;4252.857143;4249.285714;4205.238095;75.43524502;4290
TLKM.JK;07/02/22;4230;4290;4210;4290;4138.623047;90285800;80;60;4244.285714;4252.142857;4213.809524;73.90470054;4230
TLKM.JK;08/02/22;4280;4280;4230;4230;4080.740234;71210400;50;-50;4230;4260;4221.904762;45.09249753;4280
TLKM.JK;09/02/22;4280;4280;4210;4280;4128.976074;95375000;70;0;4224.285714;4258.571429;4224.761905;41.57609203;4460
TLKM.JK;10/02/22;4400;4470;4340;4460;4302.624512;233984700;130;60;4227.142857;4260.714286;4233.333333;44.98677054;4450
TLKM.JK;11/02/22;4500;4550;4410;4450;4292.977051;130081900;140;-50;4265.714286;4277.857143;4250.952381;95.36895771;4400
TLKM.JK;14/02/22;4380;4400;4310;4400;4244.741699;104903700;90;20;4305.714286;4286.428571;4267.142857;106.5922359;4410
TLKM.JK;15/02/22;4400;4440;4360;4410;4254.388672;75305900;80;10;4334.285714;4293.571429;4277.619048;100.1427552;4400
TLKM.JK;16/02/22;4420;4460;4380;4400;4244.741699;90121200;80;-20;4360;4302.142857;4288.095238;91.6515139;4410
TLKM.JK;17/02/22;4400;4440;4360;4410;4254.388672;72970200;80;10;4375.714286;4302.857143;4298.571429;86.95921321;4400
TLKM.JK;18/02/22;4420;4440;4370;4400;4244.741699;71111300;70;-20;4401.428571;4312.857143;4306.190476;58.71642911;4370
TLKM.JK;21/02/22;4370;4420;4340;4370;4215.800293;58883000;80;0;4418.571429;4322.857143;4313.333333;25.44836041;4300
TLKM.JK;22/02/22;4320;4360;4250;4300;4148.27002;106985800;110;-20;4405.714286;4335.714286;4320.47619;23.70453041;4350
TLKM.JK;23/02/22;4280;4370;4270;4350;4196.505859;110562400;100;70;4384.285714;4345;4319.047619;39.5209408;4240
TLKM.JK;24/02/22;4280;4320;4200;4240;4090.387207;126158600;120;-40;4377.142857;4355.714286;4321.428571;40.70801957;4340
TLKM.JK;25/02/22;4240;4350;4240;4340;4186.858887;208757000;110;100;4352.857143;4356.428571;4319.047619;62.64031868;4350
TLKM.JK;01/03/22;4640;4650;4350;4350;4196.505859;206416900;300;-290;4344.285714;4360;4316.666667;59.12053869;4290
TLKM.JK;02/03/22;4400;4400;4270;4290;4138.623047;152165300;130;-110;4335.714286;4368.571429;4320.47619;51.91568256;4400
TLKM.JK;04/03/22;4440;4440;4300;4400;4244.741699;155369100;140;-40;4320;4369.285714;4321.904762;45.46060566;4510
TLKM.JK;07/03/22;4400;4530;4370;4510;4350.859863;177360400;160;110;4324.285714;4365;4331.904762;51.91568256;4620
TLKM.JK;08/03/22;4600;4700;4540;4620;4456.978516;234086000;160;20;4354.285714;4369.285714;4348.095238;85.41216597;4440
TLKM.JK;09/03/22;4550;4620;4420;4440;4283.330078;145145900;200;-110;4392.857143;4385;4368.095238;131.6199435;4410
TLKM.JK;10/03/22;4500;4500;4380;4410;4254.388672;130830800;120;-90;4421.428571;4387.142857;4378.095238;113.3473381;4590
TLKM.JK;11/03/22;4410;4590;4400;4590;4428.037109;143446200;190;180;4431.428571;4387.857143;4383.809524;107.9241356;4580
TLKM.JK;14/03/22;4650;4670;4540;4580;4418.390137;166572700;130;-70;4465.714286;4400.714286;4400.952381;115.5937055;4620
TLKM.JK;15/03/22;4630;4630;4570;4620;4456.978516;231077800;60;-10;4507.142857;4413.571429;4415.238095;91.59954252;4630
TLKM.JK;16/03/22;4660;4660;4550;4630;4466.625977;109961900;110;-30;4538.571429;4431.428571;4422.857143;86.29958892;4480
TLKM.JK;17/03/22;4550;4580;4450;4480;4321.918457;246300800;130;-70;4555.714286;4455;4431.428571;91.44345117;4540
TLKM.JK;18/03/22;4490;4540;4470;4540;4379.801758;210266100;70;50;4535.714286;4464.285714;4435.238095;90.34326074;4550
TLKM.JK;21/03/22;4550;4570;4520;4550;4389.44873;79691600;50;0;4550;4485.714286;4441.428571;80;4550
TLKM.JK;22/03/22;4550;4580;4540;4550;4389.44873;98699900;40;0;4570;4500.714286;4448.571429;51.63977795;4550
TLKM.JK;23/03/22;4550;4570;4500;4550;4389.44873;78299500;70;0;4564.285714;4515;4455.238095;51.26959556;4560
TLKM.JK;24/03/22;4500;4570;4500;4560;4399.095703;89578400;70;60;4560;4533.571429;4462.380952;50.99019514;4520
TLKM.JK;25/03/22;4510;4540;4480;4520;4360.507324;90053700;60;10;4551.428571;4545;4471.428571;43.75255095;4600
TLKM.JK;28/03/22;4510;4600;4500;4600;4437.68457;184131000;100;90;4535.714286;4545.714286;4481.904762;27.60262237;4560
TLKM.JK;29/03/22;4600;4620;4560;4560;4399.095703;77920800;60;-40;4552.857143;4544.285714;4493.809524;24.29971585;4580
TLKM.JK;30/03/22;4620;4620;4560;4580;4418.390137;118749100;60;-40;4555.714286;4552.857143;4509.047619;23.70453041;4580
TLKM.JK;31/03/22;4620;4640;4560;4580;4418.390137;108109700;80;-40;4560;4565;4520.47619;25.16611478;4580
TLKM.JK;01/04/22;4550;4580;4530;4580;4418.390137;86590300;50;30;4564.285714;4564.285714;4531.428571;25.72750983;4540
TLKM.JK;04/04/22;4560;4570;4490;4540;4379.801758;103480300;80;-20;4568.571429;4564.285714;4545.238095;25.44836041;4520
TLKM.JK;05/04/22;4550;4550;4500;4520;4360.507324;52172300;50;-30;4565.714286;4558.571429;4551.904762;27.60262237;4430
TLKM.JK;06/04/22;4490;4500;4420;4430;4273.683105;108368800;80;-60;4565.714286;4550.714286;4552.380952;27.60262237;4540
TLKM.JK;07/04/22;4450;4540;4440;4540;4379.801758;143921800;100;90;4541.428571;4547.142857;4543.333333;54.29197959;4580
TLKM.JK;08/04/22;4580;4610;4560;4580;4418.390137;161974500;50;0;4538.571429;4547.142857;4548.095238;53.67450401;4590
TLKM.JK;11/04/22;4610;4610;4550;4590;4428.037109;90521500;60;-20;4538.571429;4549.285714;4556.190476;53.67450401;4630
TLKM.JK;12/04/22;4620;4630;4580;4630;4466.625977;187948000;50;10;4540;4552.142857;4556.190476;55.07570547;4690
TLKM.JK;13/04/22;4700;4720;4650;4690;4524.508789;196864200;70;-10;4547.142857;4557.857143;4558.571429;63.69570517;4680
TLKM.JK;14/04/22;4700;4730;4660;4680;4514.861328;112735200;70;-20;4568.571429;4567.142857;4561.904762;83.15218406;4710
TLKM.JK;18/04/22;4720;4730;4690;4710;4543.802734;120778200;40;-10;4591.428571;4578.571429;4564.285714;89.33617622;4680
TLKM.JK;19/04/22;4740;4750;4680;4680;4514.861328;92268300;70;-60;4631.428571;4586.428571;4575.238095;64.14269806;4630
TLKM.JK;20/04/22;4680;4690;4620;4630;4466.625977;88360900;70;-50;4651.428571;4595;4581.904762;51.45501965;4620
TLKM.JK;21/04/22;4620;4670;4600;4620;4456.978516;97575800;70;0;4658.571429;4598.571429;4585.714286;42.5944329;4620
TLKM.JK;22/04/22;4620;4680;4580;4620;4456.978516;101299100;100;0;4662.857143;4601.428571;4589.047619;35.45621042;4710
TLKM.JK;25/04/22;4610;4720;4580;4710;4543.802734;92045500;140;100;4661.428571;4604.285714;4592.380952;37.16116765;4760
TLKM.JK;26/04/22;4680;4760;4670;4760;4592.038574;85945800;90;80;4664.285714;4616.428571;4599.52381;40.35556255;4770
TLKM.JK;27/04/22;4720;4790;4720;4770;4601.685547;136485600;70;50;4675.714286;4633.571429;4610.952381;54.42338433;4620
TLKM.JK;28/04/22;4850;4850;4620;4620;4456.978516;198484800;230;-230;4684.285714;4657.857143;4619.047619;64.51282634;4310
TLKM.JK;09/05/22;4560;4560;4300;4310;4157.91748;343682000;260;-250;4675.714286;4663.571429;4621.904762;69.00655593;4340
TLKM.JK;10/05/22;4120;4380;4120;4340;4186.858887;281386300;260;220;4630;4644.285714;4609.047619;155.7776193;4330
TLKM.JK;11/05/22;4400;4480;4330;4330;4177.211426;154455400;150;-70;4590;4626.428571;4597.619048;190.7878403;4300
TLKM.JK;12/05/22;4340;4390;4250;4300;4148.27002;233518500;140;-40;4548.571429;4605;4585.714286;213.3407737;4260
TLKM.JK;13/05/22;4250;4350;4230;4260;4109.681641;190889200;120;10;4490;4577.142857;4574.285714;217.8684618;4180
TLKM.JK;17/05/22;4250;4290;4180;4180;4032.504395;170880700;110;-70;4418.571429;4547.142857;4561.904762;195.3994687;4250
TLKM.JK;18/05/22;4230;4290;4190;4250;4100.034668;185359500;100;20;4334.285714;4509.285714;4550;137.095726;4210
TLKM.JK;19/05/22;4180;4230;4150;4210;4061.445801;112679300;80;30;4281.428571;4478.571429;4536.190476;55.80578567;4170
TLKM.JK;20/05/22;4220;4230;4170;4170;4022.857422;141701800;60;-50;4267.142857;4448.571429;4518.571429;59.92058236;4110
TLKM.JK;23/05/22;4160;4180;4070;4110;3964.974609;196569900;110;-50;4242.857143;4416.428571;4498.571429;59.92058236;4150
TLKM.JK;24/05/22;4120;4200;4120;4150;4003.562988;151693700;80;30;4211.428571;4380;4473.809524;64.14269806;4200
TLKM.JK;25/05/22;4200;4210;4150;4200;4051.798828;166595400;60;0;4190;4340;4448.095238;53.85164807;4300
TLKM.JK;27/05/22;4260;4300;4210;4300;4148.27002;186513500;90;40;4181.428571;4300;4425.238095;44.88079449;4250
TLKM.JK;30/05/22;4340;4340;4200;4250;4100.034668;107614100;140;-90;4198.571429;4266.428571;4405.714286;63.35839103;4310
TLKM.JK;31/05/22;4270;4330;4230;4310;4157.91748;469620300;100;40;4198.571429;4240;4385.238095;63.35839103;4290
TLKM.JK;02/06/22;4390;4390;4270;4290;4138.623047;164481100;120;-100;4212.857143;4240;4370;76.31388815;4310
TLKM.JK;03/06/22;4310;4390;4300;4310;4157.91748;108852800;90;0;4230;4236.428571;4354.285714;78.5281266;4340
TLKM.JK;06/06/22;4310;4340;4270;4340;4186.858887;79319400;70;30;4258.571429;4235;4339.52381;62.29729032;4250
TLKM.JK;07/06/22;4340;4340;4250;4250;4100.034668;142504000;90;-90;4285.714286;4237.857143;4321.904762;46.49628761;4100
TLKM.JK;08/06/22;4150;4170;4080;4100;4100;202555900;90;-50;4292.857143;4237.142857;4297.619048;33.02235895;4050
TLKM.JK;09/06/22;4080;4130;4050;4050;4050;148580200;80;-30;4264.285714;4231.428571;4265.714286;79.55231881;4020
TLKM.JK;10/06/22;4040;4080;4000;4020;4020;189186700;80;-20;4235.714286;4217.142857;4238.571429;113.9966583;4080
TLKM.JK;13/06/22;3950;4100;3930;4080;4080;156054900;170;130;4194.285714;4203.571429;4224.761905;133.5236737;4110
TLKM.JK;14/06/22;4050;4120;4020;4110;4110;117325600;100;60;4164.285714;4197.142857;4212.380952;132.0173149;4060
TLKM.JK;15/06/22;4060;4080;4030;4060;4060;94848800;50;0;4135.714286;4197.142857;4201.904762;115.8817131;4040
TLKM.JK;16/06/22;4120;4120;4030;4040;4040;96042200;90;-80;4095.714286;4190.714286;4190.47619;74.57817886;4120
TLKM.JK;17/06/22;4010;4120;3980;4120;4120;169375800;140;110;4065.714286;4179.285714;4180;32.58688021;4040
TLKM.JK;20/06/22;4050;4060;4000;4040;4040;82101200;60;-10;4068.571429;4166.428571;4177.142857;36.70993119;4110
TLKM.JK;21/06/22;4060;4120;4030;4110;4110;77489000;90;50;4067.142857;4151.428571;4167.142857;37.73340064;4050
TLKM.JK;22/06/22;4090;4090;4040;4050;4050;60907800;50;-40;4080;4137.142857;4162.380952;34.15650255;4160
TLKM.JK;23/06/22;4030;4160;4030;4160;4160;101065400;130;130;4075.714286;4120;4156.666667;35.98941643;4150
TLKM.JK;24/06/22;4230;4230;4100;4150;4150;81050700;130;-80;4082.857143;4109.285714;4159.047619;47.15728495;4070
TLKM.JK;27/06/22;4110;4120;4040;4070;4070;71574300;80;-40;4095.714286;4095.714286;4159.047619;51.91568256;4030
TLKM.JK;28/06/22;4010;4050;4000;4030;4030;128618800;50;20;4100;4082.857143;4152.857143;47.60952286;4040
TLKM.JK;29/06/22;4000;4080;4000;4040;4040;72888100;80;40;4087.142857;4077.857143;4140;53.13952883;4000
TLKM.JK;30/06/22;4110;4110;4000;4000;4000;116718900;110;-110;4087.142857;4077.142857;4130;53.13952883;4020
TLKM.JK;01/07/22;4010;4040;4000;4020;4020;39572500;40;10;4071.428571;4075.714286;4115.238095;60.94494002;3990
TLKM.JK;04/07/22;4020;4040;3840;3990;3990;115885200;200;-30;4067.142857;4071.428571;4102.380952;63.69570517;3990
TLKM.JK;05/07/22;4010;4070;3950;3990;3990;72329600;120;-20;4042.857143;4062.857143;4087.142857;54.07226206;4020
TLKM.JK;06/07/22;4050;4050;3970;4020;4020;62679000;80;-30;4020;4057.857143;4070.47619;29.43920289;4040
TLKM.JK;07/07/22;4040;4050;4010;4040;4040;42393800;40;0;4012.857143;4056.428571;4059.52381;19.7604704;4010
TLKM.JK;08/07/22;4050;4060;4000;4010;4010;64049000;60;-40;4014.285714;4050.714286;4056.666667;21.49196971;4040
TLKM.JK;11/07/22;4100;4100;4000;4040;4040;42258000;100;-60;4010;4048.571429;4054.761905;18.25741858;4010
TLKM.JK;12/07/22;4060;4060;4010;4010;4010;43399800;50;-50;4015.714286;4043.571429;4055.714286;20.70196678;3940
TLKM.JK;13/07/22;4010;4030;3930;3940;3940;96218200;100;-70;4014.285714;4040.714286;4052.380952;20.70196678;4020
TLKM.JK;14/07/22;3940;4020;3900;4020;4020;68708500;120;80;4007.142857;4025;4044.285714;34.50327797;4150
TLKM.JK;15/07/22;4040;4210;4010;4150;4150;146093800;200;110;4011.428571;4015.714286;4042.380952;33.8765265;4190
TLKM.JK;18/07/22;4110;4190;4070;4190;4190;84009400;120;80;4030;4021.428571;4047.619048;62.71629241;4160
TLKM.JK;19/07/22;4190;4190;4130;4160;4160;91367900;60;-30;4051.428571;4032.857143;4050.952381;87.45066636;4210
TLKM.JK;20/07/22;4140;4220;4140;4210;4210;82344000;80;70;4072.857143;4041.428571;4056.666667;93.75753938;4260
TLKM.JK;21/07/22;4210;4260;4180;4260;4260;107234600;80;50;4097.142857;4056.428571;4061.428571;105.1529498;4230
TLKM.JK;22/07/22;4240;4240;4190;4230;4230;59792300;50;-10;4132.857143;4073.571429;4071.428571;112.7998649;4240
TLKM.JK;25/07/22;4240;4260;4220;4240;4240;37218000;40;0;4174.285714;4090.714286;4074.761905;78.07200584;4250
TLKM.JK;26/07/22;4240;4250;4190;4250;4250;49786900;60;10;4205.714286;4108.571429;4079.047619;41.17326918;4300
TLKM.JK;27/07/22;4230;4300;4210;4300;4300;60672300;90;70;4220;4125;4087.619048;35.59026084;4240
TLKM.JK;28/07/22;4310;4320;4190;4240;4240;110767300;130;-70;4235.714286;4143.571429;4100.47619;43.53433237;4230
TLKM.JK;29/07/22;4280;4300;4210;4230;4230;108823600;90;-50;4247.142857;4160;4110;28.11540842;4300
TLKM.JK;01/08/22;4230;4300;4230;4300;4300;104724300;70;70;4250;4173.571429;4120.952381;24.49489743;4450
TLKM.JK;02/08/22;4350;4450;4250;4450;4450;112228800;200;100;4255.714286;4194.285714;4134.285714;31.0145895;4500
TLKM.JK;03/08/22;4450;4590;4410;4500;4500;251825000;180;50;4287.142857;4230.714286;4156.190476;77.39816658;4550
TLKM.JK;04/08/22;4450;4550;4450;4550;4550;186881500;100;100;4324.285714;4265;4180.47619;107.526298;4650
TLKM.JK;05/08/22;4590;4650;4530;4650;4650;268967200;120;60;4367.142857;4293.571429;4205.714286;130.3475208;4700
TLKM.JK;08/08/22;4700;4700;4650;4700;4700;191023500;50;0;4417.142857;4326.428571;4234.761905;163.270153;4640
TLKM.JK;09/08/22;4700;4700;4630;4640;4640;164453900;70;-60;4482.857143;4365;4267.619048;172.405944;4560
TLKM.JK;10/08/22;4530;4590;4490;4560;4560;162061400;100;30;4541.428571;4395.714286;4296.190476;138.4953154;4570
TLKM.JK;11/08/22;4550;4610;4520;4570;4570;123629000;90;20;4578.571429;4417.142857;4322.380952;88.9622713;4550
TLKM.JK;12/08/22;4570;4600;4530;4550;4550;124552500;70;-20;4595.714286;4441.428571;4352.380952;69.4879229;4450
TLKM.JK;15/08/22;4540;4570;4440;4450;4450;136882800;130;-90;4602.857143;4463.571429;4377.619048;59.92058236;4410
TLKM.JK;16/08/22;4530;4580;4410;4410;4410;127710800;170;-120;4588.571429;4477.857143;4391.904762;82.34653837;4550
TLKM.JK;18/08/22;4360;4550;4350;4550;4550;182044300;200;190;4554.285714;4485.714286;4402.380952;100.4750621;4600
TLKM.JK;19/08/22;4560;4610;4460;4600;4600;177623900;150;40;4532.857143;4507.857143;4420.952381;77.61320457;4650
TLKM.JK;22/08/22;4550;4660;4530;4650;4650;202320400;130;100;4527.142857;4534.285714;4439.52381;69.45365018;4660
TLKM.JK;23/08/22;4680;4710;4610;4660;4660;229431400;100;-20;4540;4559.285714;4458.095238;83.46656017;4750
TLKM.JK;24/08/22;4660;4770;4600;4750;4750;189007900;170;90;4552.857143;4574.285714;4478.571429;94.99373413;4570
TLKM.JK;25/08/22;4680;4700;4560;4570;4570;179495700;140;-110;4581.428571;4592.142857;4502.857143;120.613511;4490
TLKM.JK;26/08/22;4510;4540;4480;4490;4490;184317100;60;-20;4598.571429;4593.571429;4518.095238;106.5252038;4520
TLKM.JK;29/08/22;4370;4550;4360;4520;4520;101529800;190;150;4610;4582.142857;4527.142857;85.04900548;4480
TLKM.JK;30/08/22;4580;4620;4480;4480;4480;118884300;140;-100;4605.714286;4569.285714;4540.47619;89.22950612;4560
TLKM.JK;31/08/22;4420;4600;4420;4560;4560;175300400;180;140;4588.571429;4557.857143;4552.380952;101.2305243;4580
TLKM.JK;01/09/22;4560;4650;4530;4580;4580;120871700;120;20;4575.714286;4557.857143;4564.761905;97.78499252;4600
TLKM.JK;02/09/22;4540;4620;4540;4600;4600;106985000;80;60;4564.285714;4558.571429;4570.952381;90.71147352;4620
TLKM.JK;05/09/22;4560;4630;4550;4620;4620;77323800;80;60;4542.857143;4562.142857;4575.714286;46.44505202;4510
TLKM.JK;06/09/22;4610;4620;4510;4510;4510;61970100;110;-100;4550;4574.285714;4579.047619;54.46711546;4490
TLKM.JK;07/09/22;4500;4560;4480;4490;4490;106145700;80;-10;4552.857143;4581.428571;4572.380952;51.22313465;4560
TLKM.JK;08/09/22;4500;4640;4500;4560;4560;123389200;140;60;4548.571429;4577.142857;4562.380952;55.5063274;4600
TLKM.JK;09/09/22;4550;4600;4530;4600;4600;50307800;70;50;4560;4574.285714;4558.571429;46.54746681;4540
TLKM.JK;12/09/22;4600;4600;4530;4540;4540;74820600;70;-60;4565.714286;4570.714286;4560.47619;48.94116974;4520
TLKM.JK;13/09/22;4540;4560;4520;4520;4520;91510200;40;-20;4560;4562.142857;4559.047619;49.32882862;4480
TLKM.JK;14/09/22;4490;4530;4460;4480;4480;97919200;70;-10;4548.571429;4545.714286;4557.619048;47.75931722;4500
TLKM.JK;15/09/22;4540;4600;4500;4500;4500;125599900;100;-40;4528.571429;4539.285714;4559.047619;41.80453382;4410
TLKM.JK;16/09/22;4500;4500;4410;4410;4410;210277300;90;-90;4527.142857;4540;4563.333333;42.70608298;0